border_size=1
usage=map

Gg          , Gg          , Gg          , Gg          , Gg          , Gg          , Gg          , Gg          , Gg          , Gg          , Gg          , Gs^Fds      , Gs^Fds      , Gs^Fds      , Ch          , Ds          , Ds          , Ww          , Ds          , Ds          , Ds          , Ds          , Ds          , Ds          , Hh^Fms      , Hh^Fms      , Mm          , Mm          
Gg          , Gg          , Gg          , Gg^Vc       , Gg          , Gg          , Re^Gvs      , Gg          , Re^Gvs      , Gg          , Gg          , Gg          , Gs^Fds      , Gs^Fds      , Ds          , Ds          , Ds          , Ww          , Ds          , Dd^Vda      , Ds          , Ds          , Rp          , Cud         , Cud         , Mm          , Mm          , Mm          
Gg          , Gg          , Gg          , Gg          , Gg^Fet      , Gg          , Re^Gvs      , Re^Gvs      , Re^Gvs      , Gg          , Gg          , Gg          , Gg          , Gs^Fds      , Ds          , Dd^Vdt      , Ds          , Ww          , Ch          , Ds          , Ch          , Rp          , Rp          , Rp          , Rp          , Cud         , Cud         , Mm          
Gg          , Gg          , Gg          , Gg          , Gg          , Gg          , Gg          , Gg          , Gg          , Gg          , Gg          , Gg          , Gg^Fet      , Gg          , Ds          , Ds          , Ds          , Ww          , Ch          , 1 Kh        , Ch          , Rp          , Rp          , Rp          , Rp          , Rp          , Cud         , Mm          
Gg          , Gg          , Gg          , Gg          , Gg^Fet      , Gg          , Gg          , Gg          , Gg          , Gg^Vl       , Gg          , Gg          , Gg          , Gg          , Ds          , Ds          , Rd          , Ww^Bw/      , Ww          , Ch          , Chr         , Rp          , Rp          , Rp          , Cud         , Cud         , Mm          , Mm          
Gg          , Gs^Fds      , Gs^Fds      , Gg          , Gg          , Gg          , Re^Gvs      , Gg          , Gg          , Gg          , Gg          , Gg          , Gg^Fet      , Gg          , Ch          , Rd          , Ds          , Ds          , Ww          , Rp          , Rp          , Ch          , Rp          , Cud         , Hh^Fms      , Mm          , Hh^Fms      , Mm          
Gg          , Gs^Fds      , Gg          , Gg          , Gg          , Gg          , Re^Gvs      , Re^Gvs      , Re^Gvs      , Gg          , Gg          , Gg          , Gg          , Gs          , Gs          , Ds          , Ds          , Dd^Vda      , Ds          , Ww          , Ww          , Rp          , Ww          , Gs^Fds      , Gs^Fds      , Hh^Fms      , Gs^Fds      , Hh^Fms      
Gs          , Gg          , Gg          , Gg^Vc       , Gg          , Gg          , Gg          , Re^Gvs      , Gg          , Gg          , Gg          , Gg          , Gs^Fds      , Gg          , Gs          , Gs          , Gs          , Ds          , Wwf         , Ww          , Ds          , Ww^Bw|      , Ds          , Ww          , Ww          , Ww          , Ww          , Gs^Fds      
Gs          , Gs          , Gs          , Gg          , Gs          , Gg          , Gg          , Gg          , Gg          , Gg          , Gg          , Gs^Fds      , Hh^Vo       , Gg          , Gs          , Gs          , Ww          , Ww          , Gs          , Ch          , Ds          , Ds          , Dd^Vdt      , Ds          , Ds          , Gs^Fds      , Gs^Fds      , Ww          
Ww          , Gs          , Ww          , Gs          , Gs          , Gs          , Gg          , Gs^Fds      , Gs^Fds      , Gg          , Gs          , Gs^Fds      , Hh^Fms      , Gs^Fds      , Gs^Fds      , Ww          , Ww          , Gs          , Gs          , Gs^Fds      , Gs^Fds      , Ds          , Ds          , Ds          , Ds          , Gs^Fds      , Gs^Fds      , Gs^Fds      
Ww          , Ww          , Ww          , Ww          , Gs          , Gs          , Gs^Fds      , Gg^Vo       , Gs^Fds      , Gg          , Gs          , Gs          , Gs          , Gs^Fds      , Ww          , Ww          , Gs          , Gs          , Gg          , Gg          , Gg          , Gs^Fds      , Gs^Fds      , Ds          , Ch          , Gs^Fds      , Gs^Fds      , Gs^Fds      
Gs          , Gs          , Ww          , Ww          , Ww          , Ww          , Ww          , Gs^Fds      , Gs^Fds      , Gs          , Gs          , Gs^Fds      , Gs^Fds      , Gs^Fds      , Gs^Fds      , Ww          , Ww          , Gs          , Gg          , Gg          , Re^Gvs      , Gg          , Gg          , Gs^Fds      , Gg          , Gs^Fds      , Gg          , Gs^Fds      
Gs          , Gs^Ft       , Gs^Ft       , Ww          , Gs^Ft       , Ww          , Ww          , Wwf         , Gs          , Gs          , Gs          , Gs^Fds      , Gs^Fds      , Ww          , Ww          , Ww          , Gs          , Gs          , Gg          , Re^Gvs      , Re^Gvs      , Gg          , Gg          , Gg          , Gg          , Gg          , Gg          , Gg          
Gg          , Gs          , Gs^Ft       , Gs^Ft       , Gs^Ft       , Gs^Ft       , Ww          , Ww          , Ww          , Ww          , Ww          , Ww          , Ww          , Ww          , Gs          , Ww          , Gs          , Gg          , Gg^Vc       , Gg          , Gg          , Gg          , Re^Gvs      , Re^Gvs      , Gg          , Gg          , Gg          , Gg          
Gg          , Gs          , Gs          , Gs          , Ce          , Gs^Ft       , Gs^Ft       , Ww          , Ss          , Ww          , Ss          , Ww          , Gs          , Ww          , Gs          , Gs          , Ds          , Gg          , Gg          , Gg          , Gg          , Gg          , Gg          , Gg          , Gg          , Gg^Fet      , Gg          , Gg          
Gg          , Gg          , Gs          , Ce          , 2 Ke        , Ce          , Gs^Ft       , Gs^Ft       , Gg          , Ss          , Gg          , Gs          , Gs          , Gs          , Gs          , Ds          , Ds          , Gs          , Gs          , Gg          , Gg^Wm       , Gg          , Gg          , Gg          , Ds          , Gg          , Ds          , Gg          
Gg          , Gs          , Gs          , Ce          , Ce          , Ce          , Gg          , Gg          , Gg          , Gg          , Gg^Vc       , Gg          , Gs          , Ds          , Ds          , Ds          , Dd^Dc       , Ds          , Gs          , Gg          , Gg          , Gg          , Gg          , Ds          , Dd^Vdt      , Ds          , Gg          , Gg          
Gg          , Gg          , Gs          , Gs          , Gs          , Gs          , Gg          , Gs^Fds      , Gs^Fds      , Gg          , Gg          , Gg          , Gs          , Ds          , Gs          , Ds          , Ds          , Ds          , Gs          , Gs          , Gg          , Gg          , Ds          , Ds          , Ds          , Ds          , Ds          , Gg          
Gg          , Gg          , Gg          , Gg          , Gg          , Gg          , Gg          , Gs^Fds      , Gg          , Gg          , Gg          , Gg          , Gg          , Gs          , Gs          , Ds          , Ds          , Ds          , Gs          , Gs          , Gs          , Gg          , Gg          , Gg          , Gg          , Gg          , Gg          , Gg          
