border_size=1
usage=map

Mm          , Mm          , Mm          , Hh^Fmf      , Hh^Fmf      , Hh^Fmf      , Gs^Fmf      , Ss          , Ss          , Ww          , Ww          , Gs          , Ds          , Ds^Ft       , Ds^Ft       , Ds^Ft       , Ds          , Ds          , Rd          , Ds          , Ds          , Ds          
Mm          , Mm          , Mm          , Hh^Fmf      , Hh^Fmf      , Hh^Fmf      , Gs^Fmf      , Ss          , Rd          , Gs          , Ww          , Ds          , Ds          , Ds          , Ds          , Ds^Ft       , Ds          , Rd          , Ds          , Ds          , Hd          , Ds          
Mm          , Mm          , Hh          , Hh^Fmf      , Hh          , Gs^Fmf      , Gs^Fmf      , Rd          , Ss          , Gs          , Ww          , Ds          , Ds          , Dd^Vdt      , Ds          , Ds^Ft       , Rd          , Rd          , Ds          , Ds          , Ds          , Hd          
Mm          , Mm          , Ce          , Ce          , Ce          , Gg          , Gs^Fmf      , Gs^Fmf      , Gs          , Ss          , Ss          , Ww          , Ds          , Ds          , Ds          , Ds          , Rd          , Ds          , Ds          , Ds^Dr       , Ds          , Hd          
Ww          , Mm          , Ce          , 2 Ke        , Ce          , Gs^Fmf      , Gs^Fmf      , Gs          , Gs^Fmf      , Ss          , Ww          , Ww          , Gs          , Ds          , Ds          , Rd          , Ds          , Ds          , Ds          , Ds          , Ds          , Ds          
Ww          , Hh^Fmf      , Hh^Fmf      , Ce          , Hh^Fmf      , Hh          , Gs          , Gs          , Wwf         , Ss          , Ww          , Gs          , Ds          , Ds          , Rd          , Rd          , Ds          , Ds^Ft       , Ds^Ft       , Ds          , Rd          , Rd          
Mm          , Ww          , Wwf         , Gg          , Gs^Fmf      , Gg          , Gs^Fmf      , Ss          , Ww          , Wwf         , Gs          , Gs          , Ds          , Ds          , Rd          , Ds          , Ds          , Ds^Ft       , Ds          , Ds          , Rd          , Ds          
Mm          , Mm          , Wwf         , Gs^Fmf      , Hh^Fmf      , Gs^Fmf      , Gs^Fmf      , Ss          , Ww          , Gs^Ft       , Gs          , Ds          , Ds          , Rd          , Ds          , Ds          , Ds          , Ds          , Dd^Vdt      , Rd          , Ds          , Ds          
Mm          , Hh^Fmf      , Ww          , Hh          , Gg          , Gs^Fmf      , Gs^Fmf      , Ww          , Gs^Ft       , Gs^Ft       , Gs          , Ds          , Ds          , Rd          , Rd          , Ds          , Dd^Dc       , Ds          , Rd          , Rd          , Ds          , Ds          
Mm          , Hh^Vo       , Gg          , Wwf         , Gs^Fmf      , Gs^Fmf      , Ww          , Ww          , Gs^Ft       , Gs          , Ds          , Ds          , Ds          , Ds^Dr       , Rd          , Ds          , Ds          , Ds          , Rd          , Ds          , Ds          , Ds          
Mm          , Hh^Fmf      , Hh^Fmf      , Wwf         , Ss          , Gs^Fmf      , Ww          , Gs^Ft       , Gs          , Gs          , Gs          , Ds          , Ds          , Ds          , Ds          , Rd          , Ds          , Ds          , Ds          , Rd          , Ds          , Ds          
Mm          , Mm          , Gs          , Ww          , Ww          , Ww          , Gs^Ft       , Gs^Ft       , Gs          , Gs          , Ds          , Ds          , Ds          , Hd          , Ds          , Rd          , Rd          , Rd          , Rd          , Rd          , Ds          , Ds          
Mm          , Mm          , Hh^Fmf      , Gs^Fmf      , Ww          , Gs^Ft       , Gs          , Gs^Ft       , Gs^Ft       , Gs          , Rd          , Ds          , Ds          , Hd          , Ds          , Ds          , Rd          , Ds          , Ds          , Ds          , Hd          , Ds          
Mm          , Mm          , Gs          , Gs          , Gs          , Wwf         , Gs          , Gs^Ft       , Gs          , Gs          , Rd          , Ds          , Ds          , Ds^Edp      , Ds          , Rd          , Ds          , Ds          , Ds          , Hd          , Hd          , Hd          
Mm          , Mm          , Mm          , Hh^Fmf      , Gs          , Wwf         , Ww          , Gs          , Gs          , Ds          , Dd^Vdt      , Rd          , Rd          , Ds          , Rd          , Rd          , Ds          , Ds          , Ds^Dr       , Ds          , Ds          , Ds          
Mm          , Mm          , Mm          , Hh          , Gs^Fmw      , Gs^Fmf      , Ww          , Gs          , Gs          , Ds          , Ds          , Ds          , Rd          , Ds          , Rd          , Ds          , Hd          , Ds          , Ds^Ft       , Ds^Ft       , Ds          , Ds          
Mm          , Mm          , Hh          , Hh^Fmf      , Gs          , Gs          , Wwf         , Gs          , Gs          , Gs          , Rd          , Ds          , Rd          , Rd          , Ds          , Ds          , Hd          , Ds          , Ds          , Ds^Ft       , Ds          , Ds          
Mm          , Mm          , Hh^Fmf      , Gs^Fmw      , Rd          , Gs^Fmf      , Ss^Vhs      , Wwf         , Ds          , Gs          , Ds          , Rd          , Ds^Dr       , Rd          , Rd          , Ds          , Ds          , Ds          , Dd^Vdt      , Ds          , Ds          , Ds          
Mm          , Mm          , Hh^Fmf      , Gs^Fmf      , Gs^Fmf      , Gs^Fmw      , Ss          , Ww          , Ds          , Ds          , Dd^Dc       , Ds          , Ds          , Ds^Ft       , Rd          , Ds          , Ds          , Ds          , Ds          , Ds          , Hd          , Ds          
Mm          , Mm          , Mm          , Hh          , Gs^Fmf      , Gs^Fmf      , Ss          , Ww          , Ww          , Ds          , Ds          , Ds          , Ds          , Ds^Ft       , Ds^Ft       , Rd          , Ds          , Ds^Edp      , Ds          , Ds          , Hd          , Hd          
Mm          , Mm          , Mm          , Hh^Fmf      , Gs^Fmw      , Ss          , Ss          , Ss          , Ww          , Ds          , Ds          , Ds          , Ds          , Ds          , Ds          , Rd          , Rd          , Ds          , Ds          , Hd          , Hd          , Hd          
Mm          , Mm          , Hh^Fmf      , Hh          , Hh^Fmf      , Gs^Fmf      , Gs^Fmw      , Ss          , Ww          , Ds          , Ds          , Ds          , Ce          , Rd          , Rd          , Rd          , Rd          , Ds          , Ds          , Ds          , Ds          , Ds          
Mm^Xm       , Mm          , Mm          , Hh^Fmf      , Hh          , Gs^Fmf      , Gs^Fmf      , Ss          , Ss          , Ww          , Ds          , Ce          , 1 Ke        , Ce          , Rd          , Ds          , Ds          , Rd          , Ds          , Ds          , Ds^Ft       , Ds^Ft       
Mm^Xm       , Mm          , Mm          , Hh^Fmf      , Hh^Fmf      , Hh^Fmf      , Hh          , Ss          , Ss          , Ww          , Ds          , Ce          , Ce          , Ce          , Ds          , Ds          , Ds          , Rd          , Rd          , Ds          , Ds          , Ds^Ft       
Mm^Xm       , Mm^Xm       , Mm^Xm       , Mm          , Mm          , Hh^Fmf      , Gs^Fmw      , Ss          , Ss          , Ww          , Ww          , Ds          , Ds          , Dd^Vdt      , Ds          , Ds          , Ds^Ft       , Ds          , Rd          , Ds          , Ds          , Ds          
Mm^Xm       , Mm^Xm       , Mm^Xm       , Mm          , Hh^Fmf      , Hh^Fmf      , Gs^Fmf      , Gs^Fmf      , Gs^Fmf      , Ss          , Ss          , Ww          , Ds          , Ds          , Ds          , Ds^Ft       , Ds^Ft       , Ds          , Ds          , Rd          , Ds          , Ds          
