border_size=1
usage=map

Md          , Md          , Md          , Hd          , Hd          , Hd          , Ds          , Ds          , Ds          , Ds          , Ds          , Ds          , Ds          , Ds          , Ds          , Gs^Ft       , Gs^Ft       , Gs^Ft       , Gs          , Gs          , Gs          , Ds          , Ds          , Gs          , Gs          , Gs          , Ds          , Ds          , Ds          
Md          , Md          , Hd          , Hd          , Ds          , Ds          , Dd^Dc       , Ds          , Ds          , Ds          , Ds          , Ds          , Dd^Vdt      , Ds          , Ds          , Ds          , Ds          , Gs^Ft       , Gs          , Gs          , Gs          , Ds          , Gs          , Gs          , Co          , Co          , Co          , Ds          , Ds          
Hd          , Md          , Hd          , Ds          , Hd          , Ds          , Ds          , Ds          , Co          , Co          , Co          , Ds          , Ds          , Ds          , Co          , Ds          , Gs          , Gs          , Gs          , Gs^Vht      , Gs          , Gs          , Gs^Ft       , Ds          , Co          , 3 Ko        , Co          , Ds          , Ds          
Ds          , Hd          , Ds          , Ds          , Hd          , Hd          , Ds          , Ds          , Co          , 2 Ko        , Co          , Ds          , Gs          , Ds          , Gs          , Gs          , Ds          , Ds          , Gs          , Gs          , Gs          , Gs^Ft       , Ds          , Ds          , Ds          , Co          , Ds          , Ds          , Ds          
Ds          , Ds          , Hd          , Ds          , Hd          , Ds          , Ds          , Ds          , Ds          , Co          , Ds          , Ds          , Gs          , Gs          , Gs          , Gs          , Ds          , Gs          , Gs^Ft       , Gs^Ft       , Gs          , Gs          , Ds          , Ds          , Dd^Dc       , Ds          , Ds          , Ds          , Ds          
Hd          , Ds          , Ds          , Ds          , Ds          , Ds          , Dd^Do       , Ds          , Ds          , Ds          , Ds          , Gs          , Gs          , Co          , Gs          , Ds          , Ds          , Gs          , Gs          , Gs^Ft       , Gs^Ft       , Gs          , Gs          , Ds          , Ds          , Ds          , Dd^Vdt      , Ds          , Ds          
Ds          , Ds          , Dd^Vdt      , Ds          , Ds          , Ds          , Ds          , Ds          , Ds          , Ds          , Co          , Gs          , Ds          , Gs          , Ds          , Ds          , Ds          , Gs          , Gs^Ft       , Gs^Ft       , Gs          , Gs^Ft       , Gs          , Ds          , Hd          , Ds          , Ds          , Ds          , Ds          
Hd          , Ds          , Ds          , Ds          , Ds          , Dd^Vdt      , Ds          , Ds          , Ds          , Ds          , Gs          , Gs          , Gs          , Ds          , Dd^Vda      , Ds          , Ds          , Gs          , Gs^Ft       , Gs          , Gs^Vht      , Gs          , Gs^Ft       , Gs          , Gs^Ft       , Hd          , Ds          , Ds^Dr       , Ds          
Hd          , Ds          , Hd          , Hd          , Hd          , Ds          , Hd          , Ds          , Gs^Ft       , Gs^Ft       , Gs^Ft       , Gs          , Gs          , Ds          , Ds          , Ds          , Gs          , Gs          , Gs          , Gs          , Gs          , Gs          , Gs^Ft       , Gs^Ft       , Hd          , Hd          , Hd          , Ds          , Hd          
Md          , Hd          , Md          , Hd          , Md          , Hd          , Md          , Gs^Ft       , Gs^Ft       , Gs^Ft       , Gs          , Gs          , Gs          , Gs          , Gs          , Gs          , Ds          , Ds          , Ds          , Ds          , Gs          , Gs^Ft       , Gs^Ft       , Hd          , Ds          , Ds          , Ds          , Ds          , Ds          
Md          , Md          , Md          , Md          , Md          , Md          , Gs^Ft       , Md          , Gs^Ft       , Gs^Ft       , Ds          , Ds          , Ds          , Ds          , Gs          , Gs          , Ds          , Ds^Dr       , Ds          , Gs          , Gs          , Gs          , Gs^Ft       , Hd          , Ds          , Dd^Vda      , Ds          , Ds          , Ds          
Hd          , Md          , Hd          , Md          , Gs^Ft       , Gs^Ft       , Gs^Ft       , Gs^Ft       , Gs^Ft       , Gs          , Ds          , Dd^Vdt      , Ds          , Gs          , Gs          , Gs          , Gs^Ft       , Ds          , Gs^Ft       , Ds          , Gs          , Gs          , Gs          , Ds          , Ds          , Ds          , Co          , Ds          , Ds          
Gs^Ft       , Hd          , Gs^Ft       , Gs^Ft       , Gs^Ft       , Gs^Ft       , Md          , Md          , Gs^Ft       , Gs          , Gs^Ft       , Ds          , Gs          , Gs          , Gs          , Gs^Ft       , Ds          , Ds          , Hd          , Ds          , Gs          , Gs          , Co          , Ko          , Co          , Co          , Ds          , Hd          , Hd          
Gs^Ft       , Gs^Ft       , Gs^Ft       , Gs^Ft       , Md          , Md          , Hd          , Md          , Md          , Gs^Ft       , Md          , Gs^Ft       , Gs^Ft       , Gs^Ft       , Gs^Ft       , Gs^Ft       , Hd          , Dd^Vdt      , Hd          , Gs^Ft       , Gs^Ft       , Gs          , Gs          , Co          , Gs^Ft       , Hd          , Hd          , Hd          , Hd          
Md          , Gs^Ft       , Gs^Ft       , Gs^Ft       , Md          , Md          , Hd          , Md          , Md          , Md          , Md          , Md          , Md          , Gs^Ft       , Md          , Gs^Ft       , Md          , Hd          , Hd          , Gs^Ft       , Gs          , Gs          , Gs          , Gs          , Co          , Ds          , Ds          , Hd          , Ds          
Md          , Md          , Md          , Md          , Md          , Md          , Hd          , Hd          , Hd          , Md          , Hd          , Md          , Md          , Md          , Md          , Md          , Hd          , Hd          , Hd          , Gs^Ft       , Ds          , Ds          , Ds          , Ds          , Gs^Ft       , Gs^Ft       , Ds          , Hd          , Ds          
Md          , Md          , Md          , Md          , Ce          , Ce          , Ce          , Hd          , Ds          , Ds          , Ds          , Hd          , Hd          , Md          , Hd          , Md          , Hd          , Ds          , Hd          , Hd          , Ds          , Ds          , Dd^Vda      , Ds          , Ds          , Gs          , Gs          , Ds          , Ds          
Hd          , Md          , Hd          , Hd          , Ce          , 4 Ke        , Ce          , Ds          , Ds          , Dd^Vdt      , Ds          , Ds          , Ds          , Hd          , Ds          , Hd          , Ds          , Ds          , Hd          , Hd          , Hd          , Ds          , Ds          , Ds          , Ds          , Gs          , Ds          , Ds          , Hd          
Hd          , Hd          , Hd          , Hd          , Ds          , Ce          , Ds          , Ds          , Gs^Ft       , Ds          , Ds          , Gs          , Ds          , Ds          , Ds          , Ds          , Ds          , Hd          , Ds          , Gs^Ft       , Gs^Ft       , Hd          , Gs          , Ds          , Ds          , Ds          , Ds          , Ds          , Hd          
Hd          , Hd          , Ds          , Hd          , Ds          , Ds          , Ds          , Gs^Ft       , Gs          , Gs^Ft       , Gs          , Gs          , Gs          , Gs          , Gs          , Ds          , Dd^Vdt      , Ds          , Ds          , Gs^Ft       , Gs^Ft       , Hd          , Gs          , Gs          , Ds          , Hd          , Hd          , Hd          , Hd          
Ds          , Ds          , Ds          , Ds          , Ds^Dr       , Ds          , Gs^Ft       , Gs^Ft       , Gs          , Gs          , Gs          , Gs          , Gs^Ft       , Gs          , Gs          , Ds          , Ds          , Ds          , Gs          , Ds          , Gs          , Gs^Ft       , Gs          , Gs^Ft       , Gs^Ft       , Gs^Ft       , Hd          , Dd^Vdt      , Hd          
Ds          , Ds          , Ds          , Ds          , Ds          , Ds          , Gs^Ft       , Gs          , Gs          , Gs^Vht      , Gs          , Gs          , Gs^Ft       , Gs^Ft       , Gs          , Gs          , Ds          , Ds          , Gs          , Gs          , Gs^Ft       , Gs^Ft       , Gs^Ft       , Gs^Ft       , Ds          , Gs^Ft       , Gs^Ft       , Hd          , Gs^Ft       
Ds          , Ds          , Hd          , Hd          , Ds          , Gs^Ft       , Gs^Ft       , Gs^Ft       , Gs          , Gs          , Gs          , Gs^Ft       , Gs^Ft       , Gs          , Gs          , Gs          , Gs          , Gs          , Gs          , Gs          , Gs          , Gs^Ft       , Gs^Ft       , Gs^Ft       , Gs^Ft       , Ds          , Ds          , Gs^Ft       , Gs^Ft       
Ds          , Ds          , Ds          , Hd          , Ds          , Gs^Ft       , Gs          , Gs          , Ds          , Ds          , Gs          , Gs          , Gs          , Gs          , Ds          , Ds          , Ds          , Gs          , Gs          , Ds          , Ds          , Gs          , Gs^Ft       , Ds          , Ds          , Ds          , Ds          , Gs^Ft       , Gs^Ft       
Ds          , Ds          , Gs^Ft       , Ds          , Gs^Ft       , Gs          , Ds          , Gs          , Ds          , Ds          , Ds          , Ds          , Ds          , Gs          , Gs          , Ds          , Gs          , Gs          , Gs          , Ds          , Ds          , Gs          , Gs          , Ds          , Gs          , Ds          , Ds          , Ds          , Ds          
Ds          , Ds          , Gs^Ft       , Gs^Ft       , Gs^Ft       , Gs          , Ds          , Ds          , Ds          , Ds          , Ds          , Dd^Vdt      , Ds          , Gs          , Gs          , Ds          , Ds          , Gs          , Gs          , Gs          , Ds          , Ds          , Gs          , Gs          , Gs^Ft       , Gs          , Gs          , Gs          , Ds          
Ds          , Ds          , Ds          , Gs^Ft       , Gs^Ft       , Gs          , Gs          , Gs          , Gs          , Gs          , Ds          , Ds          , Gs          , Gs          , Gs          , Gs          , Ds          , Gs          , 1 Gs        , Gs          , Gs          , Ds          , Ds          , Gs          , Gs          , Gs^Ft       , Gs          , Gs          , Gs          
Ds          , Ds          , Ds          , Ds          , Gs^Ft       , Gs          , Gs^Ft       , Gs^Ft       , Gs^Ft       , Gs          , Gs          , Ds          , Gs          , Gs          , Gs          , Gs          , Gs          , Gs          , Gs          , Gs          , Gs          , Ds          , Gs          , Gs          , Ds          , Gs          , Gs          , Gs          , Gs          
Ds          , Ds          , Dd^Vdt      , Ds          , Ds          , Gs^Ft       , Ds          , Ds          , Ds          , Gs          , Gs          , Gs          , Gs^Ft       , Gs          , Gs          , Gs          , Gs          , Gs          , Gs          , Gs          , Gs          , Gs          , Gs          , Gs          , Ds          , Ds          , Ds          , Ds          , Gs          
Ds          , Ds          , Ds          , Ds          , Ds          , Ds          , Dd^Dc       , Ds          , Ds          , Gs          , Gs          , Gs          , Gs^Ft       , Gs^Ft       , Gs          , Gs          , Gs          , Gs          , Gs          , Gs          , Gs          , Gs          , Gs          , Ds          , Ds          , Dd^Vdt      , Ds          , Gs          , Gs          
Ds          , Ds          , Ds          , Ds          , Ds          , Ds          , Ds          , Ds          , Ds          , Ds          , Ds          , Gs^Ft       , Gs^Ft       , Gs          , Gs          , Gs          , Gs          , Gs          , Gs          , Gs          , Ds          , Ds          , Ds          , Ds          , Ds          , Ds          , Ds          , Gs          , Gs          
