border_size=1
usage=map

Md          , Md          , Md          , Hd          , Hd          , Hd          , Ds          , Ds          , Ds          , Ds          , Ds          , Ds          , Ds          , Ds          , Ds          , Gs^Ft       , Gs^Ft       , Gs^Ft       , Gs          , Gd          , Gd          , Ds          , Ds          , Gd          , Gd          , Gd          , Ds          , Ds          , Ds          
Md          , Md          , Hd          , Hd          , Ds          , Ds          , Dd^Dc       , Ds          , Ds          , Ds          , Ds          , Ds          , Dd^Vdt      , Ds          , Ds          , Ds          , Ds          , Gs^Ft       , Gs          , Gs          , Gd          , Ds          , Gd          , Gd          , Co          , Co          , Co          , Ds          , Ds          
Hd          , Md          , Hd          , Ds          , Hd          , Ds          , Ds          , Ds          , Co          , Co          , Co          , Ds          , Ds          , Ds          , Co          , Ds          , Gd          , Gd          , Gd          , Gs^Vht      , Gs          , Gd          , Gs^Ft       , Ds          , Co          , 3 Ko        , Co          , Ds          , Ds          
Ds          , Hd          , Ds          , Ds          , Hd          , Hd          , Ds          , Ds          , Co          , 2 Ko        , Co          , Ds          , Gd          , Ds          , Gd          , Gd          , Ds          , Ds          , Gd          , Gs          , Gs          , Gs^Ft       , Ds          , Ds          , Ds          , Co          , Ds          , Ds          , Ds          
Ds          , Ds          , Hd          , Ds          , Hd          , Ds          , Ds          , Ds          , Ds          , Co          , Ds          , Ds          , Gd          , Gd          , Gd          , Gd          , Ds          , Gd          , Gs^Ft       , Gs^Ft       , Gs          , Gd          , Ds          , Ds          , Dd^Dc       , Ds          , Ds          , Ds          , Ds          
Hd          , Ds          , Ds          , Ds          , Ds          , Ds          , Dd^Do       , Ds          , Ds          , Ds          , Ds          , Gd          , Gd          , Co          , Gd          , Ds          , Ds          , Gd          , Gd          , Gs^Ft       , Gs^Ft       , Gd          , Gd          , Ds          , Ds          , Ds          , Dd^Vdt      , Ds          , Ds          
Ds          , Ds          , Dd^Vdt      , Ds          , Ds          , Ds          , Ds          , Ds          , Ds          , Ds          , Co          , Gd          , Ds          , Gd          , Ds          , Ds          , Ds          , Gd          , Gs^Ft       , Gs^Ft       , Gs          , Gs^Ft       , Gd          , Ds          , Hd          , Ds          , Ds          , Ds          , Ds          
Hd          , Ds          , Ds          , Ds          , Ds          , Dd^Vdt      , Ds          , Ds          , Ds          , Ds          , Gs          , Gd          , Gd          , Ds          , Dd^Vda      , Ds          , Ds          , Gd          , Gs^Ft       , Gs          , Gs^Vht      , Gs          , Gs^Ft       , Gd          , Gs^Ft       , Hd          , Ds          , Ds^Dr       , Ds          
Hd          , Ds          , Hd          , Hd          , Hd          , Ds          , Hd          , Ds          , Gs^Ft       , Gs^Ft       , Gs^Ft       , Gd          , Gd          , Ds          , Ds          , Ds          , Gd          , Gd          , Gd          , Gd          , Gs          , Gs          , Gs^Ft       , Gs^Ft       , Hd          , Hd          , Hd          , Ds          , Hd          
Md          , Hd          , Md          , Hd          , Md          , Hd          , Md          , Gs^Ft       , Gs^Ft       , Gs^Ft       , Gs          , Gd          , Gd          , Gd          , Gd          , Gd          , Ds          , Ds          , Ds          , Ds          , Gd          , Gs^Ft       , Gs^Ft       , Hd          , Ds          , Ds          , Ds          , Ds          , Ds          
Md          , Md          , Md          , Md          , Md          , Md          , Gs^Ft       , Md          , Gs^Ft       , Gs^Ft       , Ds          , Ds          , Ds          , Ds          , Gd          , Gd          , Ds          , Ds^Dr       , Ds          , Gd          , Gd          , Gs          , Gs^Ft       , Hd          , Ds          , Dd^Vda      , Ds          , Ds          , Ds          
Hd          , Md          , Hd          , Md          , Gs^Ft       , Gs^Ft       , Gs^Ft       , Gs^Ft       , Gs^Ft       , Gs          , Ds          , Dd^Vdt      , Ds          , Gd          , Gs          , Gd          , Gs^Ft       , Ds          , Gs^Ft       , Ds          , Gd          , Gs          , Gd          , Ds          , Ds          , Ds          , Co          , Ds          , Ds          
Gs^Ft       , Hd          , Gs^Ft       , Gs^Ft       , Gs^Ft       , Gs^Ft       , Md          , Md          , Gs^Ft       , Gs          , Gs^Ft       , Ds          , Gs          , Gs          , Gs          , Gs^Ft       , Ds          , Ds          , Hd          , Ds          , Gd          , Gs          , Co          , Ko          , Co          , Co          , Ds          , Hd          , Hd          
Gs^Ft       , Gs^Ft       , Gs^Ft       , Gs^Ft       , Md          , Md          , Hd          , Md          , Md          , Gs^Ft       , Md          , Gs^Ft       , Gs^Ft       , Gs^Ft       , Gs^Ft       , Gs^Ft       , Hd          , Dd^Vdt      , Hd          , Gs^Ft       , Gs^Ft       , Gs          , Gs          , Co          , Gs^Ft       , Hd          , Hd          , Hd          , Hd          
Md          , Gs^Ft       , Gs^Ft       , Gs^Ft       , Md          , Md          , Hd          , Md          , Md          , Md          , Md          , Md          , Md          , Gs^Ft       , Md          , Gs^Ft       , Md          , Hd          , Hd          , Gs^Ft       , Gd          , Gd          , Gd          , Gd          , Co          , Ds          , Ds          , Hd          , Ds          
Md          , Md          , Md          , Md          , Md          , Md          , Hd          , Hd          , Hd          , Md          , Hd          , Md          , Md          , Md          , Md          , Md          , Hd          , Hd          , Hd          , Gs^Ft       , Ds          , Ds          , Ds          , Ds          , Gs^Ft       , Gs^Ft       , Ds          , Hd          , Ds          
Md          , Md          , Md          , Md          , Ce          , Ce          , Ce          , Hd          , Ds          , Ds          , Ds          , Hd          , Hd          , Md          , Hd          , Md          , Hd          , Ds          , Hd          , Hd          , Ds          , Ds          , Dd^Vda      , Ds          , Ds          , Gs          , Gd          , Ds          , Ds          
Hd          , Md          , Hd          , Hd          , Ce          , 4 Ke        , Ce          , Ds          , Ds          , Dd^Vdt      , Ds          , Ds          , Ds          , Hd          , Ds          , Hd          , Ds          , Ds          , Hd          , Hd          , Hd          , Ds          , Ds          , Ds          , Ds          , Gd          , Ds          , Ds          , Hd          
Hd          , Hd          , Hd          , Hd          , Ds          , Ce          , Ds          , Ds          , Gs^Ft       , Ds          , Ds          , Gd          , Ds          , Ds          , Ds          , Ds          , Ds          , Hd          , Ds          , Gs^Ft       , Gs^Ft       , Hd          , Gd          , Ds          , Ds          , Ds          , Ds          , Ds          , Hd          
Hd          , Hd          , Ds          , Hd          , Ds          , Ds          , Ds          , Gs^Ft       , Gs          , Gs^Ft       , Gd          , Gd          , Gd          , Gd          , Gd          , Ds          , Dd^Vdt      , Ds          , Ds          , Gs^Ft       , Gs^Ft       , Hd          , Gd          , Gd          , Ds          , Hd          , Hd          , Hd          , Hd          
Ds          , Ds          , Ds          , Ds          , Ds^Dr       , Ds          , Gs^Ft       , Gs^Ft       , Gs          , Gs          , Gs          , Gs          , Gs^Ft       , Gs          , Gd          , Ds          , Ds          , Ds          , Gd          , Ds          , Gs          , Gd^Ft       , Gd          , Gs^Ft       , Gs^Ft       , Gs^Ft       , Hd          , Dd^Vdt      , Hd          
Ds          , Ds          , Ds          , Ds          , Ds          , Ds          , Gs^Ft       , Gs          , Gs          , Gs^Vht      , Gs          , Gs          , Gs^Ft       , Gs^Ft       , Gs          , Gd          , Ds          , Ds          , Gs          , Gs          , Gs^Ft       , Gs^Ft       , Gs^Ft       , Gs^Ft       , Ds          , Gs^Ft       , Gs^Ft       , Hd          , Gs^Ft       
Ds          , Ds          , Hd          , Hd          , Ds          , Gs^Ft       , Gs^Ft       , Gs^Ft       , Gd          , Gd          , Gd          , Gs^Ft       , Gs          , Gs          , Gd          , Gd          , Gd          , Gd          , Gd          , Gd          , Gd          , Gs^Ft       , Gs^Ft       , Gs^Ft       , Gs^Ft       , Ds          , Ds          , Gs^Ft       , Gs^Ft       
Ds          , Ds          , Ds          , Hd          , Ds          , Gs^Ft       , Gd          , Gd          , Ds          , Ds          , Gd          , Gd          , Gd          , Gd          , Ds          , Ds          , Ds          , Gd          , Gd          , Ds          , Ds          , Gd          , Gs^Ft       , Ds          , Ds          , Ds          , Ds          , Gs^Ft       , Gs^Ft       
Ds          , Ds          , Gs^Ft       , Ds          , Gs^Ft       , Gd          , Ds          , Gd          , Ds          , Ds          , Ds          , Ds          , Ds          , Gd          , Gd          , Ds          , Gd          , Gd          , Gd          , Ds          , Ds          , Gd          , Gd          , Ds          , Gd          , Ds          , Ds          , Ds          , Ds          
Ds          , Ds          , Gs^Ft       , Gs^Ft       , Gs^Ft       , Gd          , Ds          , Ds          , Ds          , Ds          , Ds          , Dd^Vdt      , Ds          , Gd          , Gd          , Ds          , Ds          , Gd          , Gs          , Gd          , Ds          , Ds          , Gd          , Gd          , Gs^Ft       , Gd          , Gd          , Gd          , Ds          
Ds          , Ds          , Ds          , Gs^Ft       , Gs^Ft       , Gd          , Gd          , Gd          , Gd          , Gd          , Ds          , Ds          , Gd          , Gd          , Gs          , Gd          , Ds          , Gd          , 1 Gd        , Gd          , Gd          , Ds          , Ds          , Gd          , Gd          , Gs^Ft       , Gd          , Gd          , Gs          
Ds          , Ds          , Ds          , Ds          , Gs^Ft       , Gd          , Gs^Ft       , Gs^Ft       , Gs^Ft       , Gd          , Gd          , Ds          , Gd          , Gd          , Gs          , Gd          , Gd          , Gd          , Gs          , Gd          , Gd          , Ds          , Gd          , Gd          , Ds          , Gd          , Gd          , Gd          , Gs          
Ds          , Ds          , Dd^Vdt      , Ds          , Ds          , Gs^Ft       , Ds          , Ds          , Ds          , Gs          , Gd          , Gs          , Gs^Ft       , Gd          , Gd          , Gs          , Gd          , Gs          , Gs          , Gs          , Gs          , Gd          , Gd          , Gd          , Ds          , Ds          , Ds          , Ds          , Gs          
Ds          , Ds          , Ds          , Ds          , Ds          , Ds          , Dd^Dc       , Ds          , Ds          , Gd          , Gs          , Gs          , Gs^Ft       , Gs^Ft       , Gs          , Gs          , Gs          , Gd          , Gd          , Gs          , Gd          , Gd          , Gd          , Ds          , Ds          , Dd^Vdt      , Ds          , Gd          , Gs          
Ds          , Ds          , Ds          , Ds          , Ds          , Ds          , Ds          , Ds          , Ds          , Ds          , Ds          , Gs^Ft       , Gs^Ft       , Gs          , Gd          , Gd          , Gd          , Gd          , Gs          , Gd          , Ds          , Ds          , Ds          , Ds          , Ds          , Ds          , Ds          , Gd          , Gs          
