border_size=1
usage=map

Ss          , Ss          , Ss          , Ss          , Ss          , Ss          , Ss          , Ss          , Ss          , Ss          , Ss          , Ss          , Ss          , Ss          , Ww          , Ds          , Ds          , Ds          , Rp          , Rp          , Rp          , Rp          , Rp          , Rp          , Rp          , Rp          , Rp          , Rp          
Ss          , Ss          , Ss          , Ss          , Ss          , Ss          , Ss          , Ss          , Gs          , Ss          , Gs          , Ss          , Ss          , Ww          , Ww          , Wwf         , Ds          , Ds          , Ch          , Rp          , Rp          , Rp          , Rp          , Rp          , Rp          , Rp          , Rp          , Rp          
Gs          , Gs          , Gs          , Ss          , Ss          , Ss          , Ss          , Gs          , Gs          , Gs          , Gs          , Gs          , Ss          , Ss          , Ww          , Wwf         , Ds          , Ds          , Ch          , 4 Kh        , Ch          , Rp          , Rp          , Rp          , Ch          , Rp          , Rp          , Rr          
Gs          , Gs          , Ss          , Ss          , 2 Kh        , Ss          , Ss          , Ss          , Gs          , Gg          , Gs          , Ss^Vhs      , Ss          , Ss          , Ww          , Ds          , Dd^Vdt      , Ds          , Rp          , Ch          , Rp          , Rp          , Rp          , Ch          , 3 Kh        , Ch          , Rp          , Rp          
Ss          , Gs          , Gs          , Ss          , Ss          , Ss          , Ss          , Gs          , Gs          , Gg          , Gs          , Gs          , Ss          , Gs^Ft       , Ds          , Ds          , Ds          , Ds          , Rp          , Rp          , Rp          , Rp          , Rp          , Ch          , Ch          , Ch          , Rp          , Rp          
Ss          , Gs          , Gs          , Ss          , Gs          , Ss          , Gs          , Gs          , Gs          , Gs          , Ds          , Gs          , Gs^Ft       , Gs          , Gs^Ft       , Ds          , Ds          , Ds          , Ch          , Rp          , Rp          , Rp          , Rp          , Rp          , Rp          , Rp          , Rp          , Rp          
Gs          , Ss          , Ss          , Gs          , Gs          , Gs          , Gg^Vo       , Gs          , Gs          , Ds          , Gs          , Gs          , Gs^Ft       , Gs^Ft       , Gs^Ft       , Ds          , Rd          , Rd          , Ds          , Rp          , Rp          , Ch          , 5 Kh        , Rp          , Rp          , Rp          , Rp          , Rp          
Gs          , Gs          , Gs          , Gs          , Gs          , Gg          , Ds          , Ds          , Ds          , Gs          , Gg          , Gg          , Gg          , Gs^Ft       , Re          , Re          , Gg          , Ds          , Ds          , Ds          , Ds          , Ch          , Ch          , Ch          , Rp          , Rp          , Rp          , Rp          
Gs^Fp       , Gs          , Gg          , Gs          , Gg          , Gg          , Ds          , Dd^Do       , Ds          , Gg          , Gg          , Gg          , Re          , Gg          , Gg          , Gg          , Gg          , Ds          , Ds          , Dd^Vdt      , Ds          , Ds          , Ds          , Rp          , Rp          , Rp          , Rp          , Rp          
Gs^Fmf      , Gs^Fp       , Gs^Fp       , Gg          , Ds          , Gg          , Ds          , Ds          , Gg          , Gg          , Gg          , Re          , Gg          , Gg          , Ds          , Ds          , Gs          , Gg          , Gg          , Ds          , Ds          , Ds          , Ds          , Ds          , Ds          , Ch          , Rp          , Rp          
Gs^Fp       , Gs^Fp       , Gg          , Gg          , Ds          , Ds          , Ds          , Gg          , Gg          , Re          , Gg          , Gg          , Gg          , Gg          , Gg          , Ds          , Gg          , Gg          , Ds          , Gg          , Gg          , Ds          , Gg          , Ds          , Ds          , Ds          , Ds          , Rp          
Gg          , Gg          , Gg^Vo       , Gg          , Gg          , Gg          , Gg          , Gg          , Re          , Gg          , Gg          , Gs^Fp       , Gs^Fp       , Gg^Vo       , Gs^Fp       , Gg          , Ds          , Ds          , Ds          , Gg          , Gg          , Gg          , Re^Gvs      , Gg          , Gg          , Ds          , Ds          , Ds          
Gg          , Gg          , Gg          , Gg          , Re          , Re          , Gg          , Re          , Gg          , Gg          , Gs^Fp       , Gs^Fp       , Gs^Fmf      , Gs^Fp       , Gs^Fp       , Gg          , Gg          , Gg          , Gg          , Gg          , Gg          , Gg          , Gg          , Re^Gvs      , Gg          , Ds          , Ds          , Ds          
Gg          , Gg          , Gg          , Re          , Gg          , Gg          , Gg          , Gg          , Ww          , Gg          , Gg          , Gs^Fp       , Gs^Fp       , Gs^Fp       , Gg          , Gg          , Gg          , Gs^Fp       , Gs^Fp       , Gs^Fp       , Gg          , Gg          , Gg          , Gg          , Gg          , Gg          , Gg          , Ds          
Gg          , Gg          , Gg          , Gg          , Gg          , Gg^Vo       , Gg          , Ww          , Ww          , Gg          , Gg          , Gg          , Gg          , Gg          , Ww          , Wwf         , Gg          , Gs^Fp       , Gs^Fmf      , Gs^Fp       , Gg          , Gg^Vo       , Gg          , Gg          , Gg          , Gg          , Gg          , Gg          
Gg          , Gg          , Gg          , Ds          , Gg          , Gg          , Gg          , Gg          , Gg          , Ww          , Ww          , Gg          , Gg          , Gg          , Gg          , Ww          , Gg          , Gs^Fp       , Gs^Fp       , Gs^Fp       , Gg          , Gg          , Gg          , Gs^Fp       , Gs^Fp       , Gs^Fp       , Gs^Fp       , Gg          
Gg          , Gg          , Gg          , Gg          , Gg          , Gs^Fp       , Gs^Fp       , Gs^Fp       , Gg          , Wwf         , Gg          , Gg          , Gg          , Gg^Vo       , Gg          , Ww          , Ww          , Gg          , Gg          , Gg          , Gs          , Gg          , Gs^Fp       , Gs^Fp       , Gs^Fms      , Gs^Fp       , Gg          , Gg          
Gg          , Ds          , Gg          , Gg          , Gg          , Gg          , Gg          , Gs^Fp       , Gg          , Gg          , Gg          , Gg          , Gg          , Gg          , Gg          , Gg          , Ww          , Ww          , Gg          , Gs          , Gs          , Gg          , Gg          , Gs^Fp       , Gs^Fp       , Gs^Fmf      , Gs^Fp       , Gg          
Gg          , Ds          , Gg          , Ds          , Gg          , Gg          , Gg          , Gg          , Gg          , Gg          , Gs^Fp       , Gs^Fp       , Gg          , Gg          , Gs^Fp       , Gg          , Gg          , Gg          , Gs^Fp       , Gg          , Gg          , Gg          , Gs          , Gg          , Gg          , Gg^Vo       , Gg          , Gg          
Gg          , Gg          , Gg          , Ds          , Ds          , Ds          , Gg          , Gg          , Gg          , Gg          , Gg          , Gg          , Ds          , Gg          , Gg          , Gg          , Gg          , Gs^Fp       , Gs^Fms      , Gs^Fp       , Gg          , Gs          , Gs          , Gs          , Gg          , Gg          , Gg          , Gg          
Gg          , Gg          , Ds          , Ds          , Dd^Vdt      , Ds          , Ds          , Gg          , Ds          , Ds          , Gg          , Gg          , Gg          , Gg          , Gg^Vo       , Gg          , Gg          , Gs^Fp       , Gs^Fp       , Gs^Fp       , Gg          , Gs          , Gs          , Gs          , Gs          , Gg          , Gg          , Gg          
Ds          , Gg          , Ds          , Ds          , Ds          , Ds          , Ds          , Gg          , Ds          , Gg          , Ds          , Ds          , Gg          , Gg          , Gg          , Gg          , Gg          , Gg          , Gs^Fp       , Gg          , Gg          , Gg          , Gs          , Gs          , Gg          , Gg          , Gg          , Gg          
Hd          , Ds          , Ds          , Ds          , Ds          , Ds          , Hd          , Ds          , Ds          , Ds          , Hd          , Ds          , Ds          , Gg          , Gg          , Gg          , Gg          , Gg          , Gg          , Gg          , Gg          , Gg          , Gg^Vc       , Gg          , Gg          , Ds          , Ds          , Gg          
Md          , Hd          , Hd          , Hd          , Hd          , Hd          , Ce          , Ce          , Ce          , Hd          , Ds          , Ds          , Ds          , Gg          , Ds          , Gg          , Gg          , Gg          , Gg          , Gg          , Gg          , Gg          , Gg          , Gg          , Ds          , Ds          , Gg          , Gg          
Md          , Md          , Md          , Md          , Md          , Hd          , Ce          , 1 Ke        , Ce          , Hd          , Hd          , Ds          , Ds          , Ds          , Dd^Dc       , Ds          , Ds          , Ds          , Gg          , Gg          , Gg          , Ds          , Gg          , Gg          , Ds          , Dd          , Ds          , Gg          
Mm          , Md          , Mm          , Md          , Md          , Hd          , Hd          , Ce          , Ds          , Hd          , Hd          , Hd          , Hd          , Ds          , Ds          , Ds          , Dd^Vda      , Ds          , Ds          , Gg          , Ds          , Gg          , Gg          , Ds          , Ds          , Ds          , Ds          , Gg          
Md^Xm       , Mm          , Mm          , Mm          , Md          , Md          , Hd          , Ds          , Ds          , Ds          , Ds          , Hd          , Hd          , Ds          , Ds          , Ds          , Ds          , Ds          , Hd          , Ds          , Ds          , Ds          , Gg          , Ds          , Gg          , Gg          , Gg          , Gg          
Md^Xm       , Mm          , Md^Xm       , Mm          , Mm          , Mm          , Mm          , Hd          , Hd          , Ds          , Ds          , Ds          , Ds          , Hd          , Hd          , Ds          , Ds          , Ds          , Ds          , Hd          , Hd          , Ds          , Ds          , Gg          , Gg          , Gg          , Gg          , Gg          
