border_size=1
usage=map

Gs^Fdw      , Gs^Fdw      , Gg          , Gs^Fdw      , Gs^Fdw      , Ww          , Gs^Ft       , Gg          , Gs          , Gs          , Ds          , Ds          , Ds          , Ds          , Gs          , Gs          , Ss          , Ss          , Ss          , Ss          , Wo          , Ss          , Ss          , Gs^Ft       , Gs^Ft       , Gs^Ft       , Hh^Fdw      , Hh^Fdw      , Gs          , Gs          , Gs          , Gs          , Gg          , Gg          , Rd          , Rd          , Gg          , Ds          , Ds          
Gg          , Gg          , Gg          , Gg          , Gg          , Ww          , Ss          , Gs^Ft       , Hh^Fmw      , Gs          , Gs          , Gs          , Gs          , Gs          , Gs          , Gg          , Ss          , Ss          , Ss          , Ss          , Wo          , Ss          , Ss          , Gs^Ft       , Gs^Ft       , Gs^Ft       , Hh^Fdw      , Hh^Fdw      , Gs          , Gs          , Gg          , Gg          , Gg          , Gg          , Rd          , Gg          , Gg          , Ds          , Ds          
Gg          , Gg          , Gs^Fp       , Gs^Fp       , Gs^Fp       , Ss          , Ww          , Hh^Fmw      , Hh^Fmw      , Hh^Fmw      , Gs          , Gg          , Gs^Fdw      , Gg          , Gg          , Gg          , Gs^Fdw      , Ss          , Ss          , Wo          , Ss          , Wwf         , Wo          , Ss          , Gs^Ft       , Gs^Ft       , Gs^Ft       , Gs          , Gs          , Gs          , Gs          , Gg          , Gg          , Rd          , Gg          , Gg          , Gg^Vc       , Gg          , Gg          
Gg          , Gg          , Gg          , Gg          , Hh^Fmf      , Hh^Fmf      , Hh^Fmf      , 3 Wo        , Hh^Fmw      , Gs^Fdw      , Gg          , Gg          , Gg          , Gs^Fdw      , Gg^Vo       , Gg          , Gs^Fdw      , Gs^Fmw      , Gs^Fmw      , 4 Wo        , Wo          , Wo          , Ss          , Wo          , Ss          , Gs^Ft       , Gs          , Gs          , Gs^Vht      , Gs          , Gs          , Gg          , Rd          , Rd          , Gg          , Gg          , Gg          , Gg          , Gg          
Gg          , Gg          , Gs^Fp       , Gg          , Hh^Vo       , Hh^Fmf      , Gg          , Hh^Fmw      , Gs^Fp       , Gs^Fdw      , Gs^Fp       , Gs^Fmw      , Gs^Fdw      , Gg          , Gg          , Gg          , Gg          , Gs^Fp       , Gs^Fmw      , Ss          , Gs^Ft       , Ss          , Wo          , Wo          , Ss          , Gs^Ft       , Gs^Ft       , Gs          , Gs          , Gs          , Gg          , Gg          , Rd          , Gg          , Gg          , Ds          , Ds          , Ds          , Ds          
Gg          , Gs^Fp       , Gs^Fp       , Gg          , Gg          , Gg          , Gs^Fp       , Gg          , Gs^Fp       , Hh^Fp       , Gs^Fp       , Gg          , Gg          , Gg          , Gs^Fp       , Gs^Fp       , Gs^Fp       , Gg          , Gs^Fp       , Gs^Fp       , Hh^Fp       , Gs^Ft       , Wo          , Ss          , Wo          , Ss          , Gs^Ft       , Gs          , Gs          , Gs          , Gg          , Rd          , Gg          , Gg          , Ds          , Ds          , Ds          , Ds          , Gg          
Gg          , Gg          , Gg          , Gg          , Gs^Fp       , Gs^Fp       , Gs^Fp       , Gg          , Gg          , Gs^Fp       , Gg^Vo       , Gs^Fmw      , Gs^Fmw      , Gg          , Gs^Fp       , Hh^Fp       , Gs^Fp       , Gg          , Gg          , Gs^Fp       , Gs^Fp       , Gs^Ft       , Gs^Ft       , Wo          , Gs^Ft       , Wo          , Gs^Ft       , Gs^Ft       , Gs          , Gg          , Rd          , Rd          , Gg          , Gg          , Gg          , Ds          , Gg          , Ds          , Gg          
Gg          , Gg          , Gg          , Gg          , Gg          , Gs^Fp       , Gg          , Gg          , Gg          , Gg          , Gs^Fmw      , Gs^Fmw      , Gg          , Gg          , Gg          , Gs^Fp       , Gs^Fp       , Gs^Fmw      , Gg          , Gg          , Gg          , Gs^Fp       , Gs^Fp       , Gs          , Gs          , Wo          , Wo          , Gs^Ft       , Gs          , Gg          , Rd          , Gg          , Gg          , Gg          , Gg          , Gg          , Gg          , Gg          , Gg          
Gg          , Re^Gvs      , Re^Gvs      , Gg          , Gg          , Gs^Fmw      , Gs^Fmw      , Gs^Fmw      , Gs^Fdw      , Gs^Fp       , Gs^Fmf      , Gs^Fp       , Gs^Fp       , Gs^Fp       , Gg          , Gs^Fmf      , Gs^Fmf      , Gg          , Gs^Fp       , Gs^Fp       , Gs^Fp       , Gs^Fmf      , Gg          , Gs^Ft       , Gs^Ft       , Gs^Ft       , Wo          , Gs          , Rd          , Rd          , Gg          , Gg          , Ce          , Ce          , Ce          , Gg          , Gg          , Gg          , Gs^Fmw      
Gg^Vo       , Gg          , Gg          , Gg          , Gg          , Gs^Fdw      , Gg^Vo       , Gg          , Gs^Fmw      , Gs^Fmf      , Gs^Fdw      , Gs^Fdw      , Gs^Fdw      , Gs^Fp       , Gs^Fmf      , Gs^Fp       , Gg          , Gg^Vo       , Gg          , Gg          , Gg          , Gs^Fp       , Gg          , Gg          , Gg          , Gs^Ft       , Wo^Bw/      , Rd          , Gs          , Gs          , Gg          , Gg          , Ce          , 2 Ke        , Ce          , Re^Gvs      , Re^Gvs      , Gg          , Gg          
Gg          , Gg          , Rd          , Gg          , Gg          , Gg          , Gg          , Gs^Fdw      , Gg          , Gs^Fmw      , Gs^Fmf      , Gg          , Gg^Vo       , Gs^Fmf      , Gs^Fp       , Gs^Fmf      , Gs^Fmw      , Gs^Fp       , Gs^Fp       , Gs^Fp       , Gg          , Gs^Fp       , Gg          , Gg^Vo       , Rd          , Rd          , Wo          , Gs          , Gs^Ft       , Gs^Ft       , Dd          , Gg          , Gg          , Ce          , Gg          , Gg          , Gg          , Gg          , Gg          
Rd          , Rd          , Ds          , Rd          , Rd          , Rd          , Rd          , Gg          , Rd          , Gg          , Gg          , Gg          , Gg          , Gs^Fp       , Gg          , Hh^Fp       , Gs^Fdw      , Gs^Fmw      , Gg          , Hh^Fp       , Gg          , Gg          , Rd          , Rd          , Ss          , Ss          , Wo          , Gs^Ft       , Gs^Ft       , Dd          , Dd          , Gg          , Ds          , Gg          , Gg          , Gg          , Gg          , Gg^Vc       , Gg          
Ds          , Ds          , Dd^Vo       , Ds          , Ds          , Ds          , Ds          , Rd          , Ds          , Rd          , Rd          , Rd          , Rd          , Gg          , Gg          , Gg          , Gg          , Gg          , Gg          , Gg          , Rd          , Rd          , Gs          , Gs          , Ss          , Wo          , Ss          , Gs^Ft       , Gs          , Gs          , Gs          , Dd          , Gs^Fdw      , Gs^Fdw      , Gg          , Gg          , Gs^Fdw      , Gg          , Gs^Fp       
Ds          , Ds          , Ds          , Ds          , Ww          , Ds          , Ww          , Ds          , Ww          , Ds          , Ds          , Ds          , Ds          , Rd          , Rd          , Rd          , Rd          , Gg          , Rd          , Rd          , Gs          , Gs          , Ss          , Gs          , Ss          , Wo          , Ss          , Gs^Ft       , Gs          , Gs          , Ds          , Gs          , Gs          , Gs^Fdw      , Ds          , Gg          , Gg          , Gs^Fmw      , Gs^Fp       
Ds          , Ds          , Ss          , Ww          , Ss          , Ww          , Ss          , Ww          , Ss          , Ww          , Ss          , Dd          , Dd          , Ds          , Ds          , Ds          , Ds          , Rd          , Gs          , Gs          , Gs^Vht      , Gs          , Ss          , Ss          , Wo          , Wo          , Ss          , Gs^Vht      , Gs          , Gs          , Ds          , Ds          , Ds          , Ds          , Ds          , Gs          , Gg          , Gs^Fmw      , Gs^Fmw      
Ss          , Ss          , Ds          , Ss          , Ds          , Ss          , Ds          , Ss          , Ds          , Ss          , Ds          , Ss          , Ss          , Dd          , Dd          , Ce          , Ds          , Rd          , Gs          , Gs          , Ss          , Ss          , Ss          , Ww          , Wo          , Ss          , Gs          , Gs          , Gs          , Gs          , Gs          , Gs          , Ds          , Ds          , Dd          , Gs          , Gs^Vht      , Gg          , Gg          
Ds          , Ds          , Ds          , Ds          , Ds          , Ds          , Ds          , Ds          , Ds          , Ds          , Ds          , Ds          , Ds          , Ss          , Ss          , Ds          , Rd          , Rd          , Gs          , Ss          , Gs          , Ss          , Ss          , Gs^Ft       , Wo          , Ss          , Ds          , Gs          , Ds          , Gs          , Ds          , Ds          , Ds          , Ds          , Ds          , Gs          , Gs          , Gg          , Gs^Fdw      
Ds          , Ds          , Ds          , Ds          , Ds          , Ds          , Ds          , Ds          , Ds          , Ds          , Ds          , Ds          , Ds          , Ds          , Ds          , Ds          , Rd          , Gs          , Ds          , Gs          , Gs          , Gs          , Gs^Ft       , Gs^Ft       , Wo          , Gs^Ft       , Gs^Ft       , Ds          , Ds          , Gs          , Ds          , Dd^Vdt      , Ds          , Gs          , Gs          , Ds          , Gs          , Gg          , Gg          
Ds          , Ds          , Ds^Vo       , Rd          , Rd          , Rd          , Dd^Vo       , Rd          , Rd          , Rd          , Dd^Vo       , Ds          , Ds          , Ds          , Ds          , Rd          , Gs          , Gs          , Dd          , Ds          , Gs          , Gs          , Gs^Ft       , Gs^Ft       , Wo          , Gs^Ft       , Ds          , Ds          , Gs          , Gs          , Gs          , Ds          , Gs          , Gs          , Gs          , Ds          , Gs          , Gg          , Gs^Fmw      
Ds          , Ds          , Ds          , Ds          , Rd          , Ds          , Ds          , Ds          , Rd          , Ds          , Ds          , Ds          , Ds          , Ds          , Rd          , Rd          , Ds          , Dd          , Dd^Vo       , Dd          , Ds          , Gs          , Gs          , Gs^Ft       , Wo          , Gs^Ft       , Ds          , Ds          , Ds          , Gs          , Gs          , Gs          , Ds          , Gs          , Gs          , Gs          , Gg          , Gg          , Gg          
Ds          , Ds          , Rd          , Rd          , Ds          , Rd          , Rd          , Rd          , Ds          , Rd          , Rd          , Ds          , Ds          , Ds          , Rd          , Gs          , Ds          , Ds          , Ds          , Ds          , Ds          , Ce          , Ds          , Gs^Ft       , Wo          , Ds          , Dd^Vda      , Ds          , Hd          , Ds          , Ds          , Ds          , Ds          , Gs          , Gs^Fdw      , Gg          , Gg          , Gs^Fdw      , Gs^Fp       
Ds          , Ds          , Ch          , Ds          , Ds          , Ds          , Ds          , Ds          , Ds          , Ds          , Ch          , Ds          , Ds          , Rd          , Gs          , Ds          , Ds          , Ds          , Cdr         , Ds          , Dd          , Ds          , Ds          , Wo          , Gs^Ft       , Ds          , Ds          , Ds          , Hd          , Ds          , Gs          , Ds          , Gs          , Gs^Fdw      , Gg          , Gg          , Gg^Vh       , Gg          , Gs^Fmw      
Rp          , Rp          , Rp          , Rp          , Rp          , Rp          , Rp          , Rp          , Rp          , Rp          , Rp          , Rp          , Rp          , Rd          , Ds          , Ds          , Ds          , Ds          , Cdr         , Ds          , Dd          , Dd          , Ds          , Wo          , Gs^Ft       , Ds          , Gs^Ft       , Ds          , Ds          , Ds          , Gs          , Gs          , Gs^Fdw      , Gg          , Re^Gvs      , Re^Gvs      , Gg          , Gg          , Gs^Fdw      
Rp          , Rp          , Rp          , Rp          , Rp          , Rp          , Rp          , Rp          , Rp          , Rp          , Rp          , Rp          , Rp          , Rp          , Ch          , Ds          , Ds          , Rd          , Ds          , Ds          , Ds          , Ds          , Ss          , Wo          , Gs^Ft       , Gs^Ft       , Gs^Ft       , Gs          , Gs          , Gs          , Gs          , Gs          , Gs          , Gg          , Gg          , Re^Gvs      , Gg          , Gg          , Gs^Fmw      
Rp          , Rp          , Rp          , Rp          , Rp          , Rp          , Rp          , Rp          , Rp          , Rp          , Rp          , Rp          , Rp          , Rp          , Rp          , Rp          , Rd          , Rd          , Ds          , Ds          , Ds          , Ce          , Ss          , Wo          , Gs^Ft       , Ds          , Ds          , Gs^Ft       , Gs          , Gs          , Ds          , Gs          , Ds          , Ds          , Ds          , Gg          , Gg          , Gg          , Gg          
Rp          , Ch          , Kh          , Rp          , Rp          , Rp          , Rp          , Rp          , Rp          , Rp          , Rp          , Rp          , Rp          , Rp          , Rp          , Rp          , Rp          , Ds          , Dd^Vo       , Ds          , Ds          , Gs^Ft       , Wo          , Wo          , Dd^Vda      , Ds          , Ds          , Ds          , Gs          , Gs          , Ds          , Ds          , Ds          , Dd^Vdt      , Ds          , Gg          , Gg          , Gg          , Gg          
Rp          , Ch          , Ch          , Ch          , Rp          , Rp          , Ch          , Ch          , Ch          , Rp          , Rp          , Rp          , Rp          , Rp          , Rp          , Rp          , Rp          , Ds          , Ds          , Ds          , Gs^Ft       , Gs^Ft       , Wo          , Gs^Ft       , Gs^Ft       , Ds          , Gs          , Gs          , Gs          , Ds          , Dd^Dc       , Ds          , Ds          , Ds          , Gs^Fdw      , Gg          , Gg          , Gg^Wm       , Gg          
Rp          , Rp          , Rp          , Rp          , Rp          , Rp          , Chr         , 1 Kh        , Ch          , Rp          , Rp          , Rp          , Rp          , Rp          , Rp          , Rp          , Rp          , Ds          , Ds          , Ds          , Gs^Ft       , Gs^Ft       , Wo          , Gs^Ft       , Ds          , Ds          , Gs          , Gs          , Ds          , Ds          , Ds          , Dd          , Gs^Fdw      , Gs^Fdw      , Gg          , Gg          , Ds          , Gg          , Gg          
Rp          , Rp          , Rp          , Rp          , Rp          , Rp          , Rp          , Ch          , Rp          , Rp          , Rp          , Rp          , Rp          , Rp          , Rp          , Rp          , Ds          , Cdr         , Ds          , Ds          , Gs^Ft       , Wo          , Gs^Ft       , Gs^Ft       , Ds          , Ds          , Gs          , Ds          , Ds          , Dd^Vdt      , Ds          , Dd          , Ds          , Gs^Fdw      , Gs^Fdw      , Gs^Fdw      , Ds          , Ds          , Gg          
Rp          , Rp          , Rp          , Rp          , Ch          , Rp          , Rp          , Rp          , Rp          , Rp          , Rp          , Rp          , Rp          , Rp          , Ds          , Ds          , Ds          , Ds          , Ds          , Gs^Ft       , Gs^Ft       , Wo          , Gs^Ft       , Ds          , Ds          , Gs          , Gs          , Ds          , Gs          , Ds          , Ds          , Ds          , Ds          , Gs^Fdw      , Ds          , Ds          , Dd^Vdt      , Ds          , Ds          
