border_size=1
usage=map

Ww          , Gs^Ft       , Gs^Ft       , Gs^Fp       , Gs^Fp       , Gs^Fp       , Gs^Fp       , Gs^Fp       , Gs^Fmf      , Gs^Fmf      , Gs^Fp       , Gs^Fp       , Gs^Fp       , Gs^Fp       , Gg          , Re          , Gg          , Gs^Fp       , Gs^Fp       , Gs^Fp       , Gs^Fmf      , Gs^Fp       , Gs^Fms      , Gs^Fms      , Gs^Fms      
Ww          , Ss          , Gs^Ft       , Gs^Fp       , Gs^Fp       , Gs^Fp       , Gs^Fp       , Gs^Fp       , Gs^Fp       , Gs^Fp       , Gs^Fp       , Gs^Fp       , Gg          , Gg          , Re          , Re          , Gg          , Gs^Fp       , Gs^Fp       , Gs^Fmf      , Gs^Fp       , Gs^Fp       , Gg          , Gs^Fms      , Gll^Fp      
Ss          , Ww          , Gs^Ft       , Gs^Fp       , Gs^Fp       , Gg^Ve       , Gs^Fp       , Gs^Fp       , Gs^Fmf      , Gs^Fp       , Gg          , Gg          , Re          , Re          , Gg          , Gg          , Gg          , Gs^Fp       , Gs^Fp       , Gs^Fp       , Gg          , Gg          , Gs^Fp       , Gll^Fmf     , Gll^Fp      
Ss          , Ww          , Ss          , Gs^Ft       , Gs^Ft       , Gs^Fp       , Gs^Ft       , Gs^Fmf      , Gs^Fmf      , Gs^Fp       , Gg          , Re          , Gg          , Gg          , Ce          , Gg^Wm       , Ce          , Gg          , Gs^Fp       , Gs^Fp       , Gs^Fp       , Gg^Ve       , Gg          , Gll^Fp      , Gll^Fp      
Gs          , Ww          , Ww          , Ss          , Gs^Ft       , Gs^Ft       , Gs^Ft       , Gs^Fp       , Gs^Fp       , Gs^Fp       , Gg          , Re          , Ce          , Gg          , Ce          , 1 Ke        , Ce          , Gs^Fp       , Gs^Fp       , Gs^Fmf      , Gs^Fmf      , Gs^Fp       , Gs^Fp       , Gll^Fp      , Gs^Fms      
Gs          , Ww          , Ww          , Ss          , Ss          , Gs^Ft       , Gs^Ft       , Gs^Ft       , Gg          , Gs^Fmf      , Gg          , Re          , Gg          , Gg          , Gg          , Ce          , Gg          , Gg          , Gs^Fp       , Gs^Fp       , Gs^Fp       , Gs^Fp       , Gs^Fp       , Gll^Fp      , Gs^Fms      
Ds          , Gs          , Ww          , Ww          , Ss          , Gs^Ft       , Gs^Ft       , Gg          , Gg^Vc       , Gg          , Gg          , Re          , Gg          , Gs^Fp       , Gs^Fp       , Gg          , Gg          , Gs^Fp       , Gs^Fp       , Gs^Fp       , Gs^Fp       , Gg          , Gs^Fp       , Gg          , Gg          
Ds          , Gs          , Gs          , Ww          , Ww          , Ss          , Gg          , Gg          , Re^Gvs      , Re^Gvs      , Gg          , Re          , Gg          , Gs^Fp       , Gg^Ve       , Gs^Fp       , Gg          , Gs^Fp       , Gg          , Gg^Fet      , Gg          , Gg          , Gg          , Gg          , Gg          
Ds          , Ds          , Gs          , Ww          , Ww          , Ss          , Ss          , Gg          , Gg          , Gg          , Gg          , Re          , Gg          , Gs^Fmf      , Gs^Fp       , Gs^Fmf      , Gs^Ft       , Gg          , Gg          , Gg          , Re^Gvs      , Gg          , Gs^Ft       , Gs^Ft       , Gs^Ft       
Gs          , Gs          , Gs          , Gs^Ft       , Ss          , Ww          , Ww          , Ss          , Ss          , Gs^Fms      , Gg          , Re          , Ce          , Gs^Fp       , Gs^Ft       , Gs^Ft       , Ww          , Gs^Ft       , Gg          , Re^Gvs      , Gg          , Gg          , Ss          , Gs^Ft       , Gs^Ft       
Gs^Fms      , Gs^Fms      , Gs          , Gs          , Gs          , Ss          , Ss          , Ww          , Ww          , Ss          , Ss          , Re          , Ss          , Gs^Ft       , Ww          , Ww          , Ww          , Ww          , Ww          , Gg          , Ss          , Gg          , Ss          , Gs^Ft       , Ss          
Gs^Fms      , Gs          , Gs          , Gs^Vht      , Gs          , Gs^Ft       , Gs^Ft       , Ss          , Ss          , Ww          , Ww          , Ww^Bw|      , Ww          , Ww          , Ww          , Ww          , Gs^Ft       , Ww          , Gg          , Ww          , Ww          , Ss          , Ww          , Ss          , Ss          
Gs          , Gs          , Gs^Fms      , Gs          , Gs          , Gs          , Gs          , Gs          , Gs^Ft       , Ss          , Ss          , Ww^Bw|      , Ss          , Ww          , Gs^Ft       , Gs^Ft       , Gs^Ft       , Gg          , Gg          , Gg          , Gg          , Ww          , Ss          , Ss          , Gs^Ft       
Gs          , Gs^Fms      , Gs^Fms      , Gs^Fms      , Gs          , Gs          , Gs^Ft       , Gs          , Gs          , Gs^Ft       , Gs          , Re          , Gs          , Gs^Ft       , Gs          , Gs^Ft       , Gg          , Gg          , Re^Gvs      , Re^Gvs      , Gg          , Gs^Ft       , Gs^Ft       , Gs^Ft       , Gs^Ft       
Gs          , Gs          , Gs^Fms      , Gs          , Ds          , Gs          , Gs          , Gs^Ft       , Gs          , Gs          , Re          , Re          , Gs          , Gs          , Gs          , Gg          , Gs^Ft       , Gg          , Gg          , Gg          , Gs^Vh       , Gg          , Gg          , Gs^Ft       , Gg          
Gs^Fms      , Gs          , Gs          , Gs          , Gs          , Ds          , Gs          , Gs          , Re          , Re          , Gs          , Gs          , Ds          , Ds          , Gs          , Gs          , Gs^Ft       , Gs^Ft       , Gg          , Gg          , Gg          , Gg          , Gs^Fp       , Gg          , Gll^Fp      
Gs^Fms      , Gs^Fms      , Gs^Fms      , Gs          , Gs          , Gs          , Re          , Re          , Gs          , Gs          , Ce          , Gs          , Gs          , Ds          , Gs          , Gs^Ft       , Gs^Ft       , Gs          , Gg          , Gll^Fp      , Gll^Fp      , Gll^Fp      , Gs^Fp       , Gll^Fp      , Gll^Fp      
Gs^Fms      , Gs^Fms      , Gs          , Gs          , Gs^Vht      , Gs          , Re          , Gs          , Gg          , Ce          , 2 Ke        , Ce          , Gs^Fms      , Gs          , Gs          , Gs          , Gs          , Gg          , Gs^Fp       , Gs^Fp       , Gg          , Gs^Fp       , Gs^Fp       , Gll^Fmf     , Gll^Fp      
Gs^Fms      , Gs^Fms      , Gs^Fms      , Gs          , Gs          , Gs          , Re          , Gs          , Gg          , Ce          , Ce          , Ce          , Gs^Fms      , Gs          , Gs^Fp       , Gll^Fp      , Gg          , Gg          , Gg          , Gg          , Gg          , Gs^Fp       , Gs^Fp       , Gll^Fmf     , Gll^Fp      
Gs^Fms      , Gs          , Gs          , Gs          , Re          , Re          , Gs          , Gs          , Gg          , Gs^Fms      , Gs^Fms      , Gs^Fms      , Gs^Fms      , Gs          , Gs^Fp       , Gg          , Gs^Vc       , Gg          , Gll^Fp      , Gs^Fp       , Gs^Fp       , Gs^Fp       , Gs^Fp       , Gll^Fp      , Gg          
Gs          , Gs          , Re          , Re          , Gs          , Gs          , Gs^Fms      , Gs^Fms      , Gg          , Gg          , Gs^Fms      , Gs^Fms      , Gs^Fms      , Gg          , Gg          , Gg          , Gg          , Gg          , Gll^Fmf     , Gll^Fp      , Gll^Fmf     , Gll^Fp      , Gg          , Gg          , Gs^Fms      
Re          , Re          , Gs          , Gs          , Gs          , Gs          , Gs^Fms      , Gs^Fms      , Gs^Fms      , Gs^Fms      , Gs^Fms      , Gs^Fms      , Gs^Fms      , Gs^Fms      , Gg          , Gll^Fp      , Gll^Fp      , Gll^Fp      , Gll^Fp      , Gll^Fp      , Gll^Fp      , Gll^Fp      , Gg          , Gs^Fms      , Gs^Fms      
