border_size=1
usage=map

Ww          , Gg          , Gg          , Gs^Fp       , Gs^Fp       , Gs^Fp       , Gs^Fp       , Gs^Fp       , Gs^Fmf      , Gs^Fmf      , Gs^Fp       , Gs^Fp       , Gs^Fp       , Gs^Fp       , Gg          , Re          , Gg          , Gs^Fp       , Gs^Fp       , Gs^Fp       , Gs^Fmf      , Gs^Fp       , Gs^Fp       
Gs          , Ww          , Gg          , Gs^Fp       , Gs^Fp       , Gs^Fp       , Gs^Fp       , Gs^Fp       , Gs^Fp       , Gs^Fp       , Gs^Fp       , Gs^Fp       , Gg          , Gg          , Re          , Re          , Gg          , Gs^Fp       , Gs^Fp       , Gs^Fmf      , Gs^Fp       , Gs^Fp       , Gs^Fp       
Gs          , Ww          , Gg          , Gs^Fp       , Gs^Fp       , Gg^Ve       , Gs^Fp       , Gs^Fp       , Gs^Fmf      , Gs^Fp       , Gg          , Gg          , Re          , Re          , Gg          , Gg          , Gg          , Gs^Fp       , Gs^Fp       , Gs^Fp       , Gg^Ve       , Gs^Fp       , Gs^Fp       
Gs          , Ww          , Gg          , Gs^Fp       , Gs^Fmf      , Gs^Fp       , Gs^Fp       , Gs^Fmf      , Gs^Fmf      , Gs^Fp       , Gg          , Re          , Gg          , Gg          , Ce          , Gg^Wm       , Ce          , Gg          , Gs^Fp       , Gs^Fp       , Gs^Fp       , Gs^Fp       , Gs^Fp       
Gs          , Ww          , Gg          , Gs^Fp       , Gs^Fp       , Gs^Fp       , Gs^Fmf      , Gs^Fp       , Gs^Fp       , Gs^Fp       , Gg          , Re          , Ce          , Gg          , Ce          , 1 Ke        , Ce          , Gs^Fp       , Gs^Fp       , Gs^Fmf      , Gs^Fmf      , Gs^Fp       , Gs^Fp       
Gs          , Ww          , Ww          , Gg          , Gg          , Gs^Fp       , Gs^Fp       , Gs^Fp       , Gg          , Gs^Fmf      , Gg          , Re          , Gg          , Gg          , Gg          , Ce          , Gg          , Gg          , Gs^Fp       , Gs^Fp       , Gs^Fp       , Gs^Fp       , Gs^Fp       
Gs          , Gs          , Gs          , Ww          , Gg          , Gs^Fp       , Gs^Fp       , Gg          , Gg^Vc       , Gg          , Gg          , Re          , Gg          , Gs^Fp       , Gs^Fp       , Gg          , Gg          , Gs^Fp       , Gs^Fp       , Gs^Fp       , Gs^Fp       , Gg          , Gs^Fp       
Ds          , Ds          , Gs          , Ww          , Ww          , Gg          , Gg          , Gg          , Re^Gvs      , Re^Gvs      , Gg          , Re          , Gg          , Gs^Fp       , Gg^Ve       , Gs^Fp       , Gg          , Gs^Fp       , Gg          , Gs^Fmf      , Gg          , Gg          , Gs^Fp       
Gs          , Ds          , Gs          , Ww          , Ww          , Ss          , Ss          , Gg          , Gg          , Gg          , Gg          , Re          , Gg          , Gs^Fmf      , Gs^Fp       , Gs^Fmf      , Gs^Fms      , Gg          , Gg          , Gg          , Re^Gvs      , Gg          , Gg          
Gs^Fms      , Gs          , Gs          , Gs          , Ss          , Ww          , Ww          , Ss          , Ss          , Gs^Fms      , Gg          , Re          , Ce          , Gs^Fp       , Gs^Fms      , Gs^Fms      , Ww          , Gs^Fms      , Gg          , Re^Gvs      , Gg          , Gg          , Gs^Fp       
Gs^Fms      , Gs^Fms      , Gs          , Gs          , Gs          , Ss          , Ss          , Ww          , Ww          , Ss          , Ss          , Re          , Ss          , Gs^Fms      , Ww          , Ww          , Ww          , Ww          , Ww          , Gg          , Ss          , Gg          , Gg          
Gs          , Gs          , Gs          , Gs^Vht      , Gs          , Gs          , Gs          , Ss          , Ss          , Ww          , Ww          , Ww^Bw|      , Ww          , Ww          , Ww          , Ww          , Gs^Fms      , Ww          , Gg          , Ww          , Ww          , Ss          , Ww          
Gs          , Gs          , Gs^Fms      , Gs          , Gs          , Gs          , Gs          , Gs          , Gs^Ft       , Ss          , Ss          , Ww^Bw|      , Ss          , Ww          , Gs^Fms      , Gs^Fms      , Gs^Fp       , Gg          , Gg          , Gg          , Gg          , Ww          , Ss          
Gs          , Gs^Fms      , Gs^Fms      , Gs^Fms      , Gs          , Gs          , Gs^Ft       , Gs          , Gs          , Gs^Ft       , Gs          , Re          , Gs          , Gs^Fms      , Gs^Fp       , Gs^Fp       , Gs^Fp       , Gg          , Re^Gvs      , Re^Gvs      , Gg          , Gs^Fp       , Gs^Fp       
Gs          , Gs          , Gs^Fms      , Gs          , Gs          , Gs          , Gs          , Gs^Ft       , Gs          , Gs          , Re          , Re          , Gs          , Gg          , Gg          , Gs^Fp       , Gg          , Gg          , Gg          , Gg          , Gg          , Gs^Fp       , Gg          
Gs^Fms      , Gs          , Gs          , Gs          , Gs          , Gs          , Gs          , Gs          , Re          , Re          , Gs          , Gs          , Ds          , Ds          , Gs          , Gg          , Gs          , Gs          , Gg          , Gg^Vh       , Gg          , Gg          , Gs^Fp       
Gs^Fms      , Gs^Fms      , Gs          , Gs^Vht      , Gs          , Gs          , Re          , Re          , Gs          , Gs          , Ce          , Gs          , Gs          , Ds          , Gs          , Gs          , Gs          , Gs          , Gs          , Gg          , Gg          , Gs^Fp       , Gs^Fp       
Gs^Fms      , Gs^Fms      , Gs          , Gs          , Re          , Re          , Gs          , Gs          , Gs          , Ce          , 2 Ke        , Ce          , Gs^Fms      , Gs          , Gs          , Gs^Vht      , Gs          , Gs          , Gs^Fp       , Gs^Fp       , Gs          , Gs^Fp       , Gs^Fp       
Gs          , Gs          , Re          , Re          , Gs          , Gs          , Gs^Fp       , Gs          , Gs          , Ce          , Ce          , Ce          , Gs^Fms      , Gs          , Gs^Fp       , Gs          , Gs          , Gs          , Gs          , Gs          , Gs          , Gs^Fp       , Gs^Fp       
Re          , Re          , Gs          , Gs          , Gs^Fp       , Gs^Fp       , Gs^Fp       , Gs^Fp       , Gs^Fp       , Gs^Fms      , Gs^Fms      , Gs^Fms      , Gs^Fms      , Gs          , Gs^Fp       , Gs          , Gs^Fp       , Gs          , Gs^Fp       , Gs^Fp       , Gs^Fp       , Gs^Fp       , Gs^Fp       
