border_size=1
usage=map

Gs^Fp       , Gs^Fp       , Gs^Fp       , Gs^Fp       , Gs^Fp       , Gs^Fp       , Ww          , Ww          , Cv          , Ss          , Gs^Fds      , Gg          , Gg^Fet      , Rd          , Gg^Fet      , Gs^Fp       , Gs^Fp       , Gs^Fp       , Cv          , Gs^Fp       , Gs^Fp       , Gs^Fp       , Gs^Fp       , Ss          , Gs^Fp       , Ss          
Gs^Fp       , Gg^Ve       , Gs^Fp       , Gs^Fp       , Gs^Fp       , Ww          , Ss          , Ss          , Gs^Fds      , Gs^Fds      , Gs^Fds      , Gs^Fds      , Cv          , Rd          , Cv          , Gs^Fds      , Gs^Fds      , Gs^Fds      , Gs^Fds      , Gs^Fp       , Gs^Fp       , Gs^Fp       , Gs^Fp       , Gs^Fp       , Gs^Fp       , Gs^Fp       
Gs^Fp       , Gs^Fp       , Gs^Fp       , Gs^Fp       , Ww          , Ww          , Gs^Fds      , Gs^Fds      , Cv          , Cv          , Cv          , Cv          , Gg          , Cv          , Gg          , Cv          , Cv          , Cv          , Cv          , Gs^Fds      , Gs^Fds      , Gs^Fp       , Gs^Fp       , Gg^Ve       , Gs^Fp       , Gs^Fp       
Gs^Fp       , Gs^Fp       , Ww          , Ww          , Gs^Fds      , Gs^Fds      , Cv          , Cv          , Gg          , Gg          , Gg          , Gg          , Cv          , Gg          , Cv          , Gg          , Gg          , Gg          , Gg          , Cv          , Cv          , Gs^Fds      , Gs^Fds      , Gs^Fp       , Gs^Fp       , Gs^Fp       
Gs^Fp       , Gs^Fp       , Ww          , Gs^Fds      , Gs^Fds      , Cv          , Gg          , Gg          , Gg^Efm      , Gg^Efm      , Ggy         , Gg^Efm      , Gg^Efm      , Gg^Efm      , Gg^Efm      , Gg^Efm      , Gg^Efm      , Gg^Efm      , Gg^Efm      , Gg          , Gg          , Cv          , Gs^Fds      , Gs^Fp       , Gs^Fp       , Gs^Fp       
Gs^Fp       , Gs^Fp       , Ww          , Gs^Fds      , Cv          , Cv          , Gg          , Gg^Efm      , Ggy         , Ggy         , Ggy         , Ggy         , Cv          , Cv          , Cv          , Gg^Efm      , Ggy         , Ggy         , Cv          , Gg^Efm      , Gg          , Cv          , Cv          , Gs^Fds      , Gs^Fp       , Gs^Fp       
Gs^Fp       , Ww          , Gs^Fds      , Gs^Fds      , Cv          , Gg          , Gg^Efm      , Ggy         , Gg^Efm      , Ggy         , Ggy         , Ggy         , Cv          , 2 Kv        , Cv          , Ggy         , Ggy         , Cv          , Ggf         , Cv          , Gg^Efm      , Gg          , Cv          , Gs^Fds      , Gs^Fp       , Gs^Fp       
Gs^Fp       , Ww          , Gs^Fp       , Gs^Fds      , Cv          , Gg          , Gg          , Ggy         , Ggy         , Cv          , Ggy         , Ggy         , Ggy         , Cv          , Ggy         , Ggy         , Ggy         , Cv          , Cv          , Cv          , Gg          , Gg          , Cv          , Gs^Fds      , Gs^Fp       , Gs^Fp       
Gs^Fp       , Ww          , Ww          , Gs^Fds      , Gs^Fds      , Cv          , Gg          , Cv          , Gg^Efm      , Ggy         , Gg^Efm      , 1 Cv        , Ggy         , Ggy         , Ggy         , Cv          , Gg^Efm      , Ggy         , Gg^Efm      , Gg^Efm      , Gg          , Cv          , Gs^Fds      , Gs^Fds      , Gs^Fp       , Gs^Fp       
Gs^Fp       , Ww          , Ww          , Gs^Fp       , Gs^Fds      , Cv          , Cv          , Gg          , Gg          , Cv          , Gg          , Gg^Efm      , Cv          , Gg^Efm      , Cv          , Gg^Efm      , Gg          , Cv          , Gg          , Gg          , Cv          , Cv          , Gs^Fds      , Gs^Fp       , Gg          , Gs^Fp       
Gs^Fp       , Ww          , Gs^Fds      , Gs^Fp       , Gs^Fp       , Gs^Fds      , Gs^Fds      , Cv          , Cv          , Gg          , Cv          , Gg          , Gg          , Gg          , Gg          , Gg          , Cv          , Gg          , Cv          , Cv          , Ggy         , Ggy         , Gg^Efm      , Gg          , Gg^Efm      , Gg          
Ww          , Ww          , Gs^Fp       , Gs^Fp       , Gs^Fds      , Gs^Fds      , Gs^Fds      , Gs^Fds      , Gs^Fds      , Cv          , Gs^Fds      , Cv          , Cv          , Cv          , Cv          , Cv          , Gs^Fds      , Cv          , Gs^Fds      , Gs^Fds      , Gs^Fp       , Gg^Efm      , Gg          , Gg          , Re^Gvs      , Gg          
Ww          , Ww          , Gs^Fp       , Gs^Fp       , Gs^Fds      , Gs^Fds      , Gs^Fds      , Gs^Fds      , Gs^Fp       , Gs^Fds      , Gs^Fp       , Gs^Fds      , Gg^Fet      , Rd          , Gg^Fet      , Gs^Fds      , Gs^Fp       , Gs^Fds      , Gs^Fp       , Gs^Fp       , Gs^Fp       , Gs^Fp       , Gg          , Re^Gvs      , Gg          , Gg          
Ww          , Ww          , Gs^Fp       , Gs^Fp       , Gs^Fp       , Gs^Fds      , Gs^Fp       , Gs^Fp       , Gs^Ft       , Gs^Fp       , Gs^Fp       , Gs^Fp       , Cv          , Rd          , Cv          , Gs^Fp       , Gs^Fp       , Gs^Fp       , Gs^Fp       , Gs^Fp       , Gs^Fp       , Gs^Fp       , Gs^Fp       , Gg          , Gs^Fp       , Gs^Fp       
