border_size=1
usage=map

Gs^Fp       , Gs^Fp       , Gs^Fp       , Gs^Fp       , Gs^Fp       , Gs^Fp       , Ww          , Ww          , Cv          , Ss          , Gs^Fds      , Gg          , Gg^Fet      , Rd          , Gg^Fet      , Gs^Fp       , Gs^Fp       , Gs^Fp       , Cv          , Gs^Fp       , Gs^Fp       , Gs^Fp       , Gs^Fp       , Ss          , Gs^Fp       , Ss          
Gs^Fp       , Gg^Ve       , Gs^Fp       , Gs^Fp       , Gs^Fp       , Ww          , Ss          , Ss          , Gs^Fds      , Gs^Fds      , Gs^Fds      , Gs^Fds      , Cv          , Rd          , Cv          , Gs^Fds      , Gs^Fds      , Gs^Fds      , Gs^Fds      , Gs^Fp       , Gs^Fp       , Gs^Fp       , Gs^Fp       , Gs^Fp       , Gs^Fp       , Gs^Fp       
Gs^Fp       , Gs^Fp       , Gs^Fp       , Gs^Fp       , Ww          , Ww          , Gs^Fds      , Gs^Fds      , Cv          , Cv          , Cv          , Cv          , Gg          , Cv          , Gg          , Cv          , Cv          , Cv          , Cv          , Gs^Fds      , Gs^Fds      , Gs^Fp       , Gs^Fp       , Gg^Ve       , Gs^Fp       , Gs^Fp       
Gs^Fp       , Gs^Fp       , Ww          , Ww          , Gs^Fds      , Gs^Fds      , Cv          , Cv          , Gg          , Gg          , Gg          , Gg          , Cv          , Gg          , Cv          , Gg          , Gg          , Gg          , Gg          , Cv          , Cv          , Gs^Fds      , Gs^Fds      , Gs^Fp       , Gs^Fp       , Gs^Fp       
Gs^Fp       , Gs^Fp       , Ww          , Gs^Fds      , Gs^Fds      , Cv          , Gg          , Gg          , Ggf         , Ggf         , Ggf         , Ggf         , Ggf         , Ggf         , Ggf         , Ggf         , Ggf         , Ggf         , Ggf         , Gg          , Gg          , Cv          , Gs^Fds      , Gs^Fp       , Gs^Fp       , Gs^Fp       
Gs^Fp       , Gs^Fp       , Ww          , Gs^Fds      , Cv          , Cv          , Ggf         , Ggf         , Ggf         , Ggf         , Ggf         , Ggf         , Cv          , Cv          , Cv          , Ggf         , Ggf         , Ggf         , Cv          , Ggf         , Gg          , Cv          , Cv          , Gs^Fds      , Gs^Fp       , Gs^Fp       
Gs^Fp       , Ww          , Gs^Fds      , Gs^Fds      , Cv          , Gg          , Ggf         , Ggf         , Ggf         , Ggf         , Ggf         , Ggf         , Cv          , 2 Kv        , Cv          , Ggf         , Ggf         , Cv          , Ggf         , Cv          , Ggf         , Gg          , Cv          , Gs^Fds      , Gs^Fp       , Gs^Fp       
Gs^Fp       , Ww          , Gs^Fp       , Gs^Fds      , Cv          , Gg          , Ggf         , Ggf         , Ggf         , Cv          , Ggf         , Ggf         , Ggf         , Cv          , Ggf         , Ggf         , Ggf         , Cv          , Cv          , Cv          , Gg          , Gg          , Cv          , Gs^Fds      , Gs^Fp       , Gs^Fp       
Gs^Fp       , Ww          , Ww          , Gs^Fds      , Gs^Fds      , Cv          , Gg          , Cv          , Ggf         , Ggf         , Ggf         , 1 Cv        , Ggf         , Ggf         , Ggf         , Cv          , Ggf         , Ggf         , Ggf         , Ggf         , Gg          , Cv          , Gs^Fds      , Gs^Fds      , Gs^Fp       , Gs^Fp       
Gs^Fp       , Ww          , Ww          , Gs^Fp       , Gs^Fds      , Cv          , Cv          , Gg          , Gg          , Cv          , Gg          , Ggf         , Cv          , Ggf         , Cv          , Ggf         , Gg          , Cv          , Gg          , Gg          , Cv          , Cv          , Gs^Fds      , Gs^Fp       , Gg          , Gs^Fp       
Gs^Fp       , Ww          , Gs^Fds      , Gs^Fp       , Gs^Fp       , Gs^Fds      , Gs^Fds      , Cv          , Cv          , Gg          , Cv          , Gg          , Gg          , Gg          , Gg          , Gg          , Cv          , Gg          , Cv          , Cv          , Ggf         , Ggf         , Ggf         , Gg          , Ggf         , Gg          
Ww          , Ww          , Gs^Fp       , Gs^Fp       , Gs^Fds      , Gs^Fds      , Gs^Fds      , Gs^Fds      , Gs^Fds      , Cv          , Gs^Fds      , Cv          , Cv          , Cv          , Cv          , Cv          , Gs^Fds      , Cv          , Gs^Fds      , Gs^Fds      , Gs^Fp       , Ggf         , Gg          , Gg          , Re^Gvs      , Gg          
Ww          , Ww          , Gs^Fp       , Gs^Fp       , Gs^Fds      , Gs^Fds      , Gs^Fds      , Gs^Fds      , Gs^Fp       , Gs^Fds      , Gs^Fp       , Gs^Fds      , Gg^Fet      , Rd          , Gg^Fet      , Gs^Fds      , Gs^Fp       , Gs^Fds      , Gs^Fp       , Gs^Fp       , Gs^Fp       , Gs^Fp       , Gg          , Re^Gvs      , Gg          , Gg          
Ww          , Ww          , Gs^Fp       , Gs^Fp       , Gs^Fp       , Gs^Fds      , Gs^Fp       , Gs^Fp       , Gs^Ft       , Gs^Fp       , Gs^Fp       , Gs^Fp       , Cv          , Rd          , Cv          , Gs^Fp       , Gs^Fp       , Gs^Fp       , Gs^Fp       , Gs^Fp       , Gs^Fp       , Gs^Fp       , Gs^Fp       , Gg          , Gs^Fp       , Gs^Fp       
