border_size=1
usage=map

Gs^Fp       , Gs^Fp       , Gs^Fp       , Gs^Fp       , Gs^Fp       , Gs^Fp       , Ww          , Ww          , Cv          , Ss          , Gs^Fds      , Gg          , Gg^Fet      , Rd          , Gg^Fet      , Gs^Fp       , Gs^Fp       , Gs^Fp       , Cv          , Gs^Fp       , Gs^Fp       , Gs^Fp       , Gs^Fp       , Ss          , Gs^Fp       , Ss          
Gs^Fp       , Gg^Ve       , Gs^Fp       , Gs^Fp       , Gs^Fp       , Ww          , Ss          , Ss          , Gs^Fds      , Gs^Fds      , Gs^Fds      , Gs^Fds      , Cv          , Rd          , Cv          , Gs^Fds      , Gs^Fds      , Gs^Fds      , Gs^Fds      , Gs^Fp       , Gs^Fp       , Gs^Fp       , Gs^Fp       , Gs^Fp       , Gs^Fp       , Gs^Fp       
Gs^Fp       , Gs^Fp       , Gs^Fp       , Gs^Fp       , Ww          , Ww          , Gs^Fds      , Gs^Fds      , Cv          , Cv          , Cv          , Cv          , Gg^Efm      , Cv          , Gg^Efm      , Cv          , Cv          , Cv          , Cv          , Gs^Fds      , Gs^Fds      , Gs^Fp       , Gs^Fp       , Gg^Ve       , Gs^Fp       , Gs^Fp       
Gs^Fp       , Gs^Fp       , Ww          , Ww          , Gs^Fds      , Gs^Fds      , Cv          , Cv          , Gg^Efm      , Gg^Efm      , Gg^Efm      , Gg^Efm      , Cv          , Gg          , Cv          , Gg^Efm      , Gg^Efm      , Gg^Efm      , Gg^Efm      , Cv          , Cv          , Gs^Fds      , Gs^Fds      , Gs^Fp       , Gs^Fp       , Gs^Fp       
Gs^Fp       , Gs^Fp       , Ww          , Gs^Fds      , Gs^Fds      , Cv          , Gg^Efm      , Gg^Efm      , Gg^Efmy     , Gg^Efmy     , Gg^Efmy     , Gg^Efm      , Gg          , Gg          , Gg          , Gg^Efm      , Gg^Efmy     , Gg^Efmy     , Gg^Efm      , Gg^Efm      , Gg^Efm      , Cv          , Gs^Fds      , Gs^Fp       , Gs^Fp       , Gs^Fp       
Gs^Fp       , Gs^Fp       , Ww          , Gs^Fds      , Cv          , Cv          , Gg^Efm      , Gg^Efmy     , Gg^Efmy     , Gg^Efmy     , Gg          , Gg          , Cv          , Cv          , Cv          , Gg          , Gg          , Gg^Efm      , Cv          , Gg^Efm      , Gg^Efm      , Cv          , Cv          , Gs^Fds      , Gs^Fp       , Gs^Fp       
Gs^Fp       , Ww          , Gs^Fds      , Gs^Fds      , Cv          , Gg^Efm      , Gg^Efm      , Gg^Efmy     , Gg^Efm      , Gg^Efm      , Gg^Efm      , Gg          , Cv          , 2 Kv        , Cv          , Gg          , Gg          , Cv          , Gg^Efm      , Cv          , Gg^Efm      , Gg^Efm      , Cv          , Gs^Fds      , Gs^Fp       , Gs^Fp       
Gs^Fp       , Ww          , Gs^Fp       , Gs^Fds      , Cv          , Gg^Efm      , Gg^Efm      , Gg^Efm      , Gg^Efm      , Cv          , Gg^Efm      , Gg          , Gg          , Cv          , Gg          , Gg          , Gg          , Cv          , Cv          , Cv          , Gg          , Gg^Efm      , Cv          , Gs^Fds      , Gs^Fp       , Gs^Fp       
Gs^Fp       , Ww          , Ww          , Gs^Fds      , Gs^Fds      , Cv          , Gg^Efm      , Cv          , Gg^Efm      , Gg^Efm      , Gg          , 1 Cv        , Gg^Efm      , Gg          , Gg^Efm      , Cv          , Gg^Efm      , Gg          , Gg^Efmy     , Gg^Efm      , Gg^Efm      , Cv          , Gs^Fds      , Gs^Fds      , Gs^Fp       , Gs^Fp       
Gs^Fp       , Ww          , Ww          , Gs^Fp       , Gs^Fds      , Cv          , Cv          , Gg^Efm      , Gg^Efm      , Cv          , Gg^Efm      , Gg          , Cv          , Gg          , Cv          , Gg^Efm      , Gg^Efm      , Cv          , Gg^Efm      , Gg^Efm      , Cv          , Cv          , Gs^Fds      , Gs^Fp       , Gg          , Gs^Fp       
Gs^Fp       , Ww          , Gs^Fds      , Gs^Fp       , Gs^Fp       , Gs^Fds      , Gs^Fds      , Cv          , Cv          , Gg^Efm      , Cv          , Gg^Efm      , Gg^Efm      , Gg          , Gg^Efm      , Gg^Efm      , Cv          , Gg^Efm      , Cv          , Cv          , Gg^Efmy     , Gg^Efmy     , Gg^Efmy     , Gg          , Gg^Efmy     , Gg          
Ww          , Ww          , Gs^Fp       , Gs^Fp       , Gs^Fds      , Gs^Fds      , Gs^Fds      , Gs^Fds      , Gs^Fds      , Cv          , Gs^Fds      , Cv          , Cv          , Cv          , Cv          , Cv          , Gs^Fds      , Cv          , Gs^Fds      , Gs^Fds      , Gs^Fp       , Gg^Efmy     , Gg          , Gg          , Re^Gvs      , Gg          
Ww          , Ww          , Gs^Fp       , Gs^Fp       , Gs^Fds      , Gs^Fds      , Gs^Fds      , Gs^Fds      , Gs^Fp       , Gs^Fds      , Gs^Fp       , Gs^Fds      , Gg^Fet      , Rd          , Gg^Fet      , Gs^Fds      , Gs^Fp       , Gs^Fds      , Gs^Fp       , Gs^Fp       , Gs^Fp       , Gs^Fp       , Gg          , Re^Gvs      , Gg          , Gg          
Ww          , Ww          , Gs^Fp       , Gs^Fp       , Gs^Fp       , Gs^Fds      , Gs^Fp       , Gs^Fp       , Gs^Ft       , Gs^Fp       , Gs^Fp       , Gs^Fp       , Cv          , Rd          , Cv          , Gs^Fp       , Gs^Fp       , Gs^Fp       , Gs^Fp       , Gs^Fp       , Gs^Fp       , Gs^Fp       , Gs^Fp       , Gg          , Gs^Fp       , Gs^Fp       
