border_size=1
usage=map

Ss          , Gs          , Gs          , Hh          , Hh          , Hh^Fmw      , Hh^Fmw      , Hh          , Gg          , Gg          , Gs^Fp       , Gg          , Gs^Fmw      , Gg          , Gg          , Gg          , Gs^Fmw      , Gs^Fmw      , Gs^Fmw      , Gs^Fmw      , Gs^Fmw      , Gg          , Gg          , Gg          , Gs          , Gs          , Ww          , Ww          , Wo          , Wo          
Ss          , Gs          , Gs          , Gs          , Hh^Fmw      , Hh          , Gg          , Hh^Fmw      , Gg          , Gg          , Gs^Fp       , Gs^Fp       , Gg          , Gg          , Gg          , Gg          , Gg          , Gs^Fmw      , Gs^Fp       , Gg          , Gg          , Gg          , Gg          , Gs          , Gs          , Gs          , Ww          , Ww          , Wo          , Wo          
Wwg         , Ss          , Gs          , Gs          , Gs          , Gg          , Gg^Vo       , Gg          , Gg          , Gs^Fp       , Gg          , Gg          , Ds          , Gg          , Ds          , Ds          , Gg          , Gg          , Gs^Fp       , Gs^Fp       , Gg          , Gg          , Gg^Vo       , Gg          , Gs          , Ww          , Ww          , Ww          , Wo          , Wo          
Wwg         , Ss          , Ss          , Gs          , Gs          , Gg          , Gg          , Gg          , Gs^Fp       , Gg          , Gg          , Ds          , Dd          , Ds          , Dd^Vdt      , Ds          , Gg          , Gg          , Gg          , Gg          , Gg          , Gg          , Gg          , Gg          , Gs          , Ww          , Ww          , Ww          , Wo          , Wo          
Ss          , Wwg         , Ss          , Ss          , Ce          , Ce          , Ce          , Gg          , Gg          , Gs^Fp       , Gg          , Ds          , Ds          , Ds          , Ds          , Ds          , Ds          , Gg          , Gs^Fp       , Gs^Fp       , Gg          , Gg          , Gs          , Gs          , Ww          , Ww          , Wo          , Wo          , Wo          , Wo          
Ss          , Wwg         , Ww          , Ss          , Ce          , 2 Ke        , Ce          , Gs          , Gg          , Gs^Fp       , Gg          , Gg          , Ds          , Dd^Dr       , Ds          , Dd^Dc       , Ds          , Gg          , Gs          , Gg          , Rd          , Gs          , Gs          , Gs          , Ww          , Ww          , Wo          , Wo          , Wo          , Wo          
Gs          , Ss          , Ww          , Ss          , Ss          , Ce          , Gs          , Gs          , Gg          , Gg          , Gg          , Gg          , Gg          , Ds          , Gg          , Ds          , Ds          , Ds          , Gs          , Gs          , Rd          , Gs          , Gs          , Ww          , Ww          , Wo          , Wo          , Wo          , Ww          , Ww          
Gs          , Ss          , Ss          , Ww          , Ss          , Ss          , Ss          , Ss          , Gs          , Gg^Vo       , Gg          , Gs^Fp       , Gs^Fp       , Gg          , Gs^Fp       , Gs          , Gs          , Gs          , Gs          , Gs          , Wwf         , Gs          , Wwf         , Ww          , Ww          , Wo          , Wo          , Wo          , Ww          , Ww          
Gs          , Gs          , Ss          , Ww          , Ww          , Ss          , Ww          , Ss          , Ss          , Gs          , Gs          , Gs^Fp       , Gs          , Gs          , Gs          , Gs          , Ww          , Ww          , Ww          , Ww          , Ww          , Wwf         , Ww          , Ww          , Wo          , Wo          , Wo          , Ww          , Ww          , Ww          
Gs          , Gs          , Ss          , Ss          , Ss          , Ww          , Ss          , Ww          , Ww          , Ss          , Ss          , Gs          , Ss          , Ww          , Ww          , Ww          , Ww          , Ww          , Wo          , Ww          , Wo^Bw|      , Wwf         , Wo          , Wo          , Wo          , Wo          , Wo          , Ww          , Ww          , Gs          
Gs          , Gs          , Gs          , Ss          , Gs          , Ss          , Ss          , Ss          , Ww          , Ww          , Ww          , Ss          , Ww          , Ww          , Ww          , Ww          , Wo          , Wo          , Wo          , Wo          , Wo^Bw|      , Wo          , Wo          , Wo          , Wo          , Wo          , Ww          , Ww          , Ww          , Gs          
Ds          , Gs          , Ds          , Gs          , Ds          , Gs          , Gs          , Ss          , Ss          , Ww          , Ww          , Ww          , Ww          , Ww          , Wo          , Wo          , Wo          , Wo          , Wo          , Wo          , Wo^Bw|      , Wo          , Wo          , Wo          , Ww          , Ww          , Ww          , Ww          , Gs          , Gs          
Ds          , Ds          , Dd^Vdt      , Ds          , Ds          , Gs          , Ww          , Gs          , Ww          , Ww          , Wo          , Ww          , Wo          , Wo          , Wo          , Wo          , Wo          , Wo          , Ww          , Ww          , Wo^Bw|      , Wwf         , Wo          , Ww          , Ww          , Ww          , Ss          , Ss          , Gs          , Gs^Fp       
Ds          , Ds          , Ds          , Ds          , Gs          , Gs          , Ww          , Ww          , Ww          , Ww          , Wo          , Wo          , Wo          , Wo          , Ww          , Ww          , Ww          , Ww          , Wwf         , Wwf         , Wwf         , Wwf         , Ww          , Wo          , Ww          , Ss          , Gs          , Gs          , Gs^Fp       , Gs^Fp       
Ds          , Ds          , Gs          , Gs          , Ww          , Ww          , Ww          , Ww          , Wo          , Wo          , Wo          , Wo          , Wo          , Wo          , Ww          , Ww          , Ww          , Ww          , Gs          , Gs          , Gs          , Gs          , Wwf         , Wo          , Wo          , Wwf         , Ss          , Gs          , Gs^Fp       , Gs^Fdf      
Gs          , Ds          , Gs          , Ww          , Ww          , Ww          , Wo          , Wo          , Wo          , Wo          , Ww          , Ww          , Ww          , Ww          , Ww          , Ds          , Ds          , Gs          , Rd          , Gs          , Gs^Vht      , Gs          , Ss          , Wwf         , Ww          , Wwf         , Ss          , Ss^Vhs      , Gs^Fp       , Gs^Fdf      
Gs          , Gs          , Ww          , Ww          , Wo          , Wo          , Wo          , Wo          , Ww          , Ww          , Ww          , Ww          , Ww          , Ww          , Ds          , Ds          , Rd          , Gs          , Gs          , Gs          , Gs          , Gs          , Ss          , Ww          , Ww          , Ss          , Gs^Fp       , Gs^Fp       , Gs^Fdf      , Gs^Fdf      
Ww          , Ww          , Ww          , Ww          , Wo          , Wo          , Ww          , Ww          , Ww          , Ww          , Ds          , Ds          , Ds          , Ds          , Gs          , Rd          , Gs          , Gs          , Ss          , Gs          , Ss          , Ss          , Ww          , Ww          , Ss          , Ss          , Gs^Fp       , Gs^Fmf      , Gs^Fdf      , Gs^Fdf      
Ww          , Ww          , Wo          , Wo          , Wo          , Wo          , Ww          , Ww          , Ds          , Ds          , Co          , Chr         , Chr         , Gs          , Gs          , Gs          , Ss          , Ss          , Ww          , Ss          , Ww          , Ww          , Ss          , Ss          , Gs          , Ss          , Gs^Fp       , Gs^Fp       , Gs^Fdf      , Gs^Fdf      
Wo          , Wo          , Wo          , Wo          , Wo          , Ww          , Ww          , Ww          , Ds          , Ds          , Co          , Khr         , Chr         , Gs          , Rd          , Gs          , Ss          , Ww          , Wo          , Ww          , Ss          , Ss          , Gs          , Gs          , Gs^Fp       , Gs          , Gs^Fp       , Gs^Fp       , Gs^Fdf      , Gs^Fdf      
Wo          , Wo          , Wo          , Wo          , Ww          , Ww          , Ww          , Ds          , Ds          , Ds          , Gs          , Co          , Gs          , Gs          , Rd          , Gs          , Ss          , Ww          , Ww          , Ww          , Ss          , Gs          , Gs^Fp       , Gs^Fp       , Gs^Fp       , Gs^Fp       , Gg^Ve       , Gs^Fp       , Gs^Fdf      , Gs^Fdf      
Wo          , Wo          , Ww          , Ww          , Ww          , Ww          , Ds          , Ds          , Ds          , Gs          , Gs^Fp       , Gs          , Gs          , Gs          , Gs          , Gs          , Gs          , Ss          , Ss          , Ss          , Gs          , Gs          , Gg          , Gg          , Gs^Fp       , Gs^Fp       , Gs^Fp       , Gs^Fp       , Gs^Fmf      , Gs^Fdf      
Ww          , Ww          , Ww          , Ww          , Ds          , Ds          , Ds          , Dd^Vdt      , Ds          , Gs          , Gs^Fp       , Gs          , Gs^Fp       , Gs          , Gs          , Gs          , Rd          , Gs          , Gs          , Gs          , Gs          , Gs          , Gg          , Gg          , Gg          , Gg          , Gg          , Gs^Fp       , Gs^Fp       , Gs^Fdf      
Ds          , Ww          , Ds          , Ds          , Ds          , Ds          , Ds          , Ds          , Gs          , Gs          , Gs          , Gs^Fp       , Gs^Fp       , Gs^Fp       , Gs          , Gs          , Gs          , Gs          , Rd          , Rd          , Gs          , Gg          , Gs^Fp       , Gg          , Ds          , Gg          , Gg          , Gs^Fp       , Gs^Fp       , Gs^Fdf      
Ds          , Ds          , Ds          , Ds          , Dd^Vdt      , Ds          , Ds          , Gs          , Gs^Fp       , Gs          , Gs^Fp       , Gs^Fp       , Gs^Fp       , Gs          , Gs^Fp       , Gs          , Gs^Fp       , Gs          , Gs          , Gs          , Gs^Fp       , Gs^Fp       , Gs^Fp       , Gg          , Gg          , Ds          , 1 Gg        , Gs^Fp       , Gs^Fp       , Gs^Fp       
Ds          , Ds          , Ds          , Ds          , Ds          , Ds          , Gs          , Gs          , Gs^Fp       , Gs^Fp       , Gs^Fp       , Gs^Fmf      , Gs^Fmf      , Gs^Fp       , Gs^Fp       , Gs^Fp       , Gs^Fp       , Gs^Fp       , Gs^Fp       , Gs^Fp       , Gs^Fp       , Gs^Fmf      , Gs          , Gs^Fp       , Gs^Fp       , Gg          , Gg          , Gg          , Gs^Fp       , Gs^Fp       
Gs          , Gs          , Gs          , Ds          , Gs          , Gs          , Gs^Fp       , Gs          , Gs          , Gs          , Gs^Fp       , Gs^Fp       , Gs^Fp       , Gs^Fp       , Gg          , Gg^Ve       , Gs^Fmf      , Gs^Fp       , Gs^Fp       , Gs          , Gs^Fp       , Gs          , Gs          , Gs^Fp       , Gs^Fp       , Gg          , Gg          , Gg          , Gg          , Gg          
Gs          , Gll^Fp      , Gll^Fp      , Gs          , Gs          , Gs^Fp       , Gs^Fp       , Gs          , Gs          , Gs^Fp       , Gs^Fp       , Gg          , Gg          , Gg          , Gg          , Gs^Fp       , Gs^Fp       , Gs^Fp       , Gs          , Gs          , Gs          , Gs          , Gs          , Gs          , Gs          , Gg          , Gg          , Gg          , Gg          , Gg          
