border_size=1
usage=map

Ms          , Ms          , Ms          , Ai          , Ms          , Ms          , Ms          , Ms          , Ms          , Ha          , Ms          , Ms          , Ms          , Ms          , Ms          , Ms          , Ai          , Ai          , Ai          , Ai          , Ai          , Ai          , Ai          , Ai          , Wwf         , Ww          , Wwf         , Wwr         , Wwr         , Wwr         , Wwr         , Wwr         , Wo          , Wo          , Wo          
Ha          , Ms          , Ha          , Ha          , Ha          , Ms          , Ms          , Ms          , Ai          , Ha          , Ai          , Ai          , Ai          , Ms          , Ms          , Ai          , Ai          , Wwf         , Ww^Vm       , Wwf         , Ai          , Wwf         , Wwf         , Wwf         , Chw         , Chw         , Chw         , Wwf         , Wwf         , Ww          , Ww          , Ww          , Ww          , Ww          , Qxu         
Ms          , Ha          , Aa          , Aa          , Aa          , Ms          , Ai          , Ai          , Ww          , Ai          , Wo          , Wo          , Wwf         , Ms          , Ms          , Ai          , Wwf         , Wwf         , Wwf         , Wwf         , Ai          , Ai          , Wwf         , Wwf         , Chw         , 2 Khw       , Chw         , Wwf         , Wwf         , Wwf         , Qxu         , Qxu         , Qxu         , Qxu         , Qlf         
Ha          , Ha          , Aa          , Uu          , Uu          , Ai          , Ai          , Ww          , Ww          , Wo          , Wwf         , Wwf         , Wwf         , Ai          , Xu          , Ai          , Xu          , Wwf         , Xu          , Xu          , Xu          , Wwf         , Xu          , Wwf         , Wwf         , Chw         , Ww          , Ww          , Ww          , Qxu         , Qlf         , Qlf         , Qlf         , Qlf         , Qlf         
Aa          , Aa          , Ai          , Uu          , Ai          , Ai          , Wwf         , Wwf         , Wwf         , Wwf         , Xu          , Xu          , Xu          , Xu          , Wwf         , Xu          , Wwf         , Xu          , Wwf         , Wwf         , Wwf         , Xu          , Wwf         , Wwf         , Xu          , Wwf         , Ww          , Ww^Vm       , Ww          , Qxu         , Qlf         , Qlf         , Qlf         , Qlf         , Qlf         
Ai          , Ai          , Wwf         , Ai          , Wwf         , Wwf         , Xu          , Wwf         , Xu          , Xu          , Wwf         , Wwf         , Wwf         , Wwf         , Ss          , Wwf         , Gd^Fdf      , Wwf         , Ss          , Ss          , Ss          , Wwf         , Wwf         , Wwf         , Wwf         , Xu          , Wwf         , Ww          , Qxu         , Qxu         , Qlf         , Qlf         , Qlf         , Qlf         , Qlf         
Wwf         , Wwf         , Wwf         , Wwf         , Xu          , Xu          , Gd^Fdf      , Xu          , Gd^Fdf      , Gd^Fdf      , Wwf         , Wwf         , Gd^Fdf      , Ss          , Gs^Fdf      , Gll^Fmf     , Gll^Fmf     , Gs^Fdf      , Gd^Fdf      , Gd^Fdf      , Ww          , Wwf         , Xu          , Wwf         , Ww          , Xu          , Wwf         , Wwf         , Qxu         , Qlf         , Qlf         , Qlf         , Qlf         , Qlf         , Qlf         
Wwf         , Wwf         , Xu          , Xu          , Wwf         , Wwf         , Wwf         , Wwf         , Wwf         , Wwf         , Ww          , Ss          , Gd^Fdf      , Gd^Fdf      , Gd^Fdf      , Gg^Ve       , Gd^Fdf      , Gd^Fdf      , Ww          , Ww          , Wwr         , Ww          , Xu          , Ww          , Ww^Vm       , Ww          , Wwf         , Wwf         , Qxu         , Qlf         , Qlf         , Qlf         , Qlf         , Qlf         , Qlf         
Xu          , Xu          , Wwf         , Wwf         , Chw         , Wwf         , Chw         , Wwf         , Ww          , Ww          , Wo          , Ww          , Ww          , Ww          , Gd^Fdf      , Gll^Fmf     , Ww          , Gd^Fdf      , Ww          , Wo          , Wwr         , Xu          , Wwf         , Ww          , Ww          , Ww          , Wwf         , Qxu         , Qlf         , Qlf         , Qlf         , Qlf         , Qlf         , Qlf         , Qxu         
Xu          , Wwf         , Ww^Vm       , Wwf         , 4 Khw       , Wwf         , Wwf         , Ww          , Wo          , Wo          , Ww          , Wo          , Wo          , Ww          , Ww          , Ww          , Wo          , Ww          , Wo          , Wo          , Wwf         , Wwr         , Xu          , Wwf         , Xu          , Wwf         , Xu          , Qxu         , Qxu         , Qlf         , Qxu         , Qlf         , Qxu         , Qxu         , Uu          
Xu          , Wwf         , Wwf         , Wwf         , Chw         , Chw         , Chw         , Ww          , Ww          , Ww          , Xu          , Ww          , Wo          , Wo          , Wo          , Wo          , Wo          , Wo          , Ww          , Ww          , Ww          , Ww          , Ur          , Xu          , Uu^Uf       , Xu          , Uu          , Xu          , Xu          , Qxu         , Qxu         , Qxu         , Uu          , Uu          , Uu          
Xu          , Xu          , Xu          , Wwf         , Wwf         , Wwf         , Wwf         , Wwf         , Wwf         , Xu          , Xu          , Ww          , Ww          , Ww          , Ww          , Ww          , Ww          , Ww          , Xu          , Xu          , Ur          , Ur          , Ur          , Uu          , Uu          , Uu          , Uu^Vud      , Uu          , Uu          , Xu          , Qxu         , Qxu         , Uu          , Uu^Vu       , Ur          
Xu          , Xu          , Xu          , Xu          , Wwf         , Xu          , Xu          , Wwf         , Wwf         , Gd^Fdf      , Gd^Fdf      , Xu          , Xu          , Xu          , Xu          , Xu          , Xu          , Ww          , Xu          , Uu          , Uu          , Ur          , Uu          , Uu          , Uu          , Uu          , Uu          , Uu          , Uu          , Uh          , Uh          , Qxu         , Qxu^Bs/     , Ur          , Uu          
Xu          , Xu          , Xu          , Xu          , Wwf         , Xu          , Xu          , Xu          , Xu          , Wwf         , Wwf         , Wwf         , Wwf         , Wwf         , Wwf         , Wwf         , Wwf         , Xu          , Xu          , Uh          , Uu          , Uu          , Uu          , Uu          , Cud         , Cud         , Cud         , Uu          , Uu          , Uu          , Ur          , Ur          , Qxu         , Uu          , Uu          
Xu          , Xu          , Ds          , Gd^Fdf      , Ww          , Wwf         , Wwf         , Xu          , Xu          , Xu          , Wwf         , Wo          , Wo          , Wwf         , Ww          , Wwf         , Ww^Vm       , Wwf         , Wwf         , Xu          , Xu          , Uu          , Uu          , Uu          , Cud         , 5 Kud       , Cud         , Uh          , Uu          , Uu          , Ur          , Uu          , Uu          , Qxu         , Uu          
Xu          , Xu          , Ds          , Ww          , Ww^Vm       , Ww          , Wwf         , Gd^Fdf      , Gd^Fdf      , Xu          , Wwf         , Wo          , Wo          , Ww          , Ww          , Ww          , Wwf         , Wwf         , Wwf         , Xu          , Uu^Uf       , Uu          , Uu^Vud      , Uu          , Uu          , Cud         , Uh          , Uu          , Cud         , Uu          , Uu          , Ur          , Ur          , Qxu         , Uu          
Xu          , Xu          , Wwf         , Ww          , Ww          , Ww          , Wwf         , Wwf         , Wwf         , Wwf         , Wwf         , Ss^Vhs      , Wwf         , Ww          , Xu          , Wwf         , Wwf         , Wwf         , Wwf         , Xu          , Uu          , Uu          , Uu          , Uu          , Uu          , Uu          , Uu          , Uu          , Uu          , Uu          , Ur          , Ur          , Uu          , Qxu^Bs\     , Ur          
Xu          , Xu          , Xu          , Wwf         , Wwf         , Gd^Fdf      , Xu          , Xu          , Xu          , Wwf         , Wwf         , Wwf         , Ss          , Ss          , Gd^Fdf      , Xu          , Xu          , Ds          , Ds          , Ss          , Ur          , Ur          , Ur          , Uu          , Ur          , Uu^Uf       , Uu          , Uu          , Ur          , Ur          , Uu          , Uu          , Qxu         , Qxu         , Uu          
Xu          , Xu          , Xu          , Xu          , Wwf         , Xu          , Xu          , Xu          , Wo          , Ww          , Xu          , Wwf         , Wwf         , Gd^Fdf      , Gd^Fdf      , Ss          , Xu          , Ds          , Ds          , Ds          , Xu          , Xu          , Xu          , Ur          , Uu          , Ur          , Ur          , Ur          , Uu          , Uu          , Uu^Vu       , Uu          , Xu          , Qxu         , Qxu         
Wwf         , Xu          , Wwf         , Xu          , Wwf         , Xu          , Wo          , Wo          , Wo          , Ww          , Xu          , Gd^Fdf      , Wwf         , Wwf         , Wwf         , Ss          , Xu          , Xu          , Xu          , Xu          , Uh          , Uu          , Re          , Xu          , Xuc         , Uu          , Uh          , Uu          , Xu          , Uu          , Xu          , Xu          , Uu          , Xu          , Xu          
Wwf         , Wwf         , Wwf         , Wwf         , Wo          , Wo          , Wo          , Wo          , Xu          , Xu          , Ds          , Ds          , Wwf         , Wwf         , Xu          , Xu          , Wwf         , Wwf         , Ww^Vm       , Xu          , Uu          , Uu          , Xu          , Re          , Uu          , Xuc         , Xuc         , Xu          , Uu          , Xu          , Uu          , Uu          , Re          , Uu          , Xu          
Wwf         , Ww^Vm       , Wwf         , Wo          , Ww          , Wo          , Wo          , Ww          , Xu          , Ds          , Ww^Vm       , Wwf         , Gd^Fdf      , Gd^Fdf      , Xu          , Wwf         , Xu          , Xu          , Xu          , Xu          , Xu          , Re          , Wwf         , Xu          , Xuc         , Uu          , Re          , Re          , Uu          , Re          , Uu^Vud      , Uu          , Uu          , Uu          , Xu          
Wwf         , Wwf         , Ww          , Ww          , Chw         , Ww          , Ww          , Ww          , Xu          , Ds          , Wwf         , Wwf         , Wwf         , Wwf         , Xu          , Wwf         , Wwf         , Wwf         , Wwf         , Wwf         , Wwf         , Xu          , Xu          , Wwf         , Wwf         , Xuc         , Xuc         , Xu          , Xuc         , Xu          , Xu          , Xu          , Xu          , Xu          , Xu          
Xu          , Xu          , Ww          , Chw         , 3 Khw       , Chw         , Ww          , Ds          , Xu          , Xu          , Xu          , Wwf         , Wwf         , Gd^Fdf      , Wwf         , Xu          , Xu          , Xu          , Xu          , Xu          , Xu          , Wwf         , Wwf         , Xu          , Wwf         , Ai          , Ai          , Ai          , Aa          , Aa          , Aa          , Aa          , Ms          , Xu          , Xu          
Xu          , Xu          , Ww          , Chw         , Chw         , Chw         , Ww          , Xu          , Uu          , Re          , Uu          , Xu          , Wwf         , Wwf         , Wwf         , Wwf         , Wwf         , Wwf         , Wwf         , Wwf         , Wwf         , Wwf         , Wwf         , Wwf         , Uu          , Wwf         , Ai          , Ai          , Cea         , Aa          , Aa          , Aa          , Ha          , Ms          , Ms          
Xu          , Ww          , Chw         , Ww          , Ww          , Ww          , Xu          , Xu          , Re          , Ql          , Xu          , Xu          , Xu          , Ds          , Xu          , Wwf         , Xu          , Wwf         , Xu          , Wwf         , Ds          , Wwf         , Xu          , Uu          , Re          , Re          , Re          , Cea         , 1 Ke        , Cea         , Aa          , Aa          , Ha          , Ms          , Ms          
Xu          , Ww          , Ww          , Ww          , Xu          , Xu          , Re          , Uu          , Ql          , Ql^Bs\      , Re          , Uu          , Xu          , Xu          , Uu          , Xu          , Uu          , Xu          , Uu          , Xu          , Xu          , Xu          , Uu          , Uu          , Re          , Aa          , Re          , Ce          , Cea         , Cea         , Aa          , Aa          , Ha          , Ms          , Ms          
Xu          , Xu          , Xu          , Xu          , Xu          , Re          , Xu          , Xu          , Ql          , Xu          , Xu          , Uu          , Xu          , Uu          , Xu          , Uu          , Uu          , Uu^Vud      , Uu          , Uu          , Re          , Uu          , Re          , Re          , Uu          , Aa          , Aa          , Re          , Aa          , Aa          , Uu          , Aa          , Ms          , Ms          , Ms          
Xu          , Uu          , Xu          , Xu          , Qxu         , Uu^Ii       , Qxu         , Xu          , Ql          , Ql          , Xu          , Uu          , Uu          , Uu          , Uu          , Xu          , Xu          , Xu          , Xu          , Re          , Xu          , Uu          , Xu          , Xu          , Xu          , Xu          , Uu          , Re          , Aa          , Uu          , Uu^Vud      , Aa          , Ha          , Ms          , Ms          
Xu          , Uu          , Re          , Xu          , Ql          , Qxu         , Ql          , Ql          , Ql          , Ql          , Ql          , Xu          , Uu          , Re          , Uu^Vud      , Uu          , Uu          , Uu^Uf       , Uu          , Xu          , Uu          , Xu          , Re          , Uu          , Re          , Uu          , Re          , Re          , Uu          , Uu          , Uu          , Aa          , Ha          , Ha          , Ha          
Xu          , Uu          , Xu          , Xu          , Ql          , Ql          , Ql          , Ql          , Ql          , Ql          , Ql          , Xu          , Xu          , Uu          , Uu          , Uu          , Uu          , Uu          , Uu          , Uu          , Uu          , Re          , Uu          , Re          , Uu          , Uu          , Uu          , Uu          , Uu          , Uu          , Xu          , Xu          , Xu          , Xu          , Xu          
Ql          , Xu          , Ql          , Ql          , Ql          , Ql          , Ql          , Ql          , Ql          , Ql          , Ql          , Ql          , Ql          , Xu          , Xu          , Xu          , Xu          , Xu          , Xu          , Xu          , Xu          , Xu          , Xu          , Xu          , Xu          , Xu          , Xu          , Xu          , Xu          , Xu          , Xu          , Xu          , Xu          , Xu          , Xu          
