border_size=1
usage=map

Gs          , Aa^Fpa      , Aa^Fpa      , Aa^Fpa      , Aa^Fpa      , Mm          , Ms          , Ms          , Ms          , Ms          , Ms          , Ha          , Ms          , Ms          , Ms          , Ms          , Ms          , Ms          , Ms          , Ms          , Ms          , Aa^Fpa      , Ha^Fpa      , Ha^Fpa      , Ai          , Ha^Fpa      , Ms          , Ha          , Ms          , Ms          , Ms          , Ms          , Ms          , Ms          , Ms          , Ms          
Aa^Fpa      , Gs          , Aa          , Aa^Fpa      , Aa^Fpa      , Ms          , Ai          , Ms          , Ms          , Ms          , Ms          , Ms          , Ms          , Ms          , Ms          , Ms          , Ms          , Ha^Fma      , Ha^Fma      , Ms          , Ha^Fma      , Ms^Vhha     , Ha^Fpa      , Ha^Fpa      , Ai          , Ha^Fpa      , Ms          , Ms          , Ha^Fpa      , Ms          , Ha^Fma      , Ha^Fma      , Ha^Vca      , Ms          , Ha^Fpa      , Ha^Fpa      
Aa^Fpa      , Gs          , Ce          , Ce          , Ce          , Aa^Fpa      , Aa^Fpa      , Ai          , Ha^Fma      , Ha^Fpa      , Ha^Fpa      , Ms          , Ha^Fma      , Ha^Vca      , Ha^Fma      , Ms          , Ha^Fpa      , Ms          , Ha^Fpa      , Ms          , Ms          , Ha^Fpa      , Ha^Fpa      , Ai          , Ha^Fma      , Ms          , Ha^Fma      , Ha^Fma      , Ha^Fma      , Ha^Fma      , Aa          , Ha^Fpa      , Aa          , Ha^Fpa      , Aa          , Aa          
Ha^Fma      , Aa^Fpa      , Ce          , 1 Ke        , Ce          , Aa          , Aa^Vea      , Ai          , Aa          , Ha^Fma      , Ha^Fma      , Ha^Fma      , Aa          , Ha^Fma      , Aa          , Aa          , Aa          , Aa          , Aa          , Ha^Fma      , Ha^Fma      , Ha^Fpa      , Rd          , Ai          , Aa          , Ha^Fma      , Aa          , Aa          , Aa          , Aa          , Ha^Fda      , Aa          , Aa^Fma      , Aa          , Ha^Fpa      , Aa          
Ms          , Ha^Fma      , Aa^Fpa      , Ce          , Aa          , Gs          , Aa^Fpa      , Ai          , Aa          , Aa          , Aa          , Aa          , Aa          , Aa          , Aa          , Gs          , Gs          , Gs          , Gs          , Aa          , Aa          , Aa          , Rd          , Rd          , Aa          , Aa          , Aa          , Aa          , Ha^Fpa      , Ha^Fpa      , Ha^Fpa      , Ha^Fpa      , Ha^Fpa      , Ha^Fpa      , Ha^Fpa      , Ha^Fpa      
Ms          , Ha^Fpa      , Ha^Fpa      , Aa^Fpa      , Aa^Fpa      , Gs          , Gs          , Ai          , Gs          , Aa          , Gs          , Gs          , Gs          , Gs          , Aa          , Aa          , Aa          , Aa          , Aa          , Aa          , Ha^Fma      , Aa          , Rd          , Aa          , Aa          , Aa          , Aa          , Aa          , Ha^Fpa      , Ms          , Ms          , Ms          , Ms          , Ha^Fpa      , Ms          , Ms          
Ms          , Ms          , Ms          , Ha^Fpa      , Ha^Fpa      , Aa^Fpa      , Ai          , Aa          , Aa          , Gs          , Gs          , Aa          , Aa          , Aa          , Ha^Fpa      , Ha^Fpa      , Ha^Fpa      , Ha^Fma      , Ha^Fpa      , Ha^Fma      , Rd          , Ha^Fpa      , Ai          , Aa          , Aa          , Aa          , Aa          , Ha^Fda      , Ha^Fpa      , Ms          , Ms          , Ms          , Ms          , Ms^Vhha     , Ms          , Ms          
Ms          , Ms          , Ms          , Ha^Voa      , Ai          , Ai          , Ha^Fpa      , Ha^Fpa      , Ha^Fma      , Aa          , Aa          , Aa          , Aa          , Aa          , Ha^Fpa      , Ms          , Ms          , Ms          , Ms          , Ha^Vca      , Ha^Fda      , Rd          , Ai          , Aa          , Rd          , Aa          , Ai          , Ha^Fma      , Rd          , Ha^Fpa      , Ce          , Ce          , Ce          , Ms          , Ms          , Ms          
Ms          , Ms          , Ms          , Ms          , Ms          , Ms          , Ms          , Ms          , Ms          , Ha^Fma      , Aa          , Gs          , Aa          , Aa          , Aa^Fma      , Ha^Fpa      , Ms          , Ms          , Ha^Fda      , Ha^Fda      , Aa          , Ai          , Aa          , Rd          , Aa          , Rd          , Aa          , Ai          , Ha^Fpa      , Rd          , Ce          , 4 Ke        , Ce          , Ms          , Ms          , Ms          
Ms          , Ms          , Ms          , Ms          , Ms          , Ms          , Ms          , Ms          , Ms          , Ha^Fma      , Aa          , Aa          , Aa          , Aa^Fma      , Ha^Fma      , Ha^Fma      , Ms          , Ha^Fda      , Aa          , Aa          , Aa          , Ai          , Aa          , Aa          , Aa          , Aa          , Aa          , Aa          , Gs          , Ha^Fpa      , Ms          , Ce          , Ms          , Ms          , Ms          , Ms          
Ms          , Ms          , Ms          , Ms          , Ms          , Ms          , Ms          , Ms          , Ms          , Ha^Fma      , Aa          , Aa^Vla      , Aa          , Aa^Fma      , Ha^Fda      , Ms          , Ha          , Ha          , Aa          , Aa          , Aa          , Rd          , Rd          , Aa          , Gs          , Gs          , Aa          , Gs          , Ha^Fpa      , Ha^Fpa      , Ms          , Ms          , Ms          , Ms          , Ms          , Ms          
Ms          , Ms          , Ms          , Ms          , Aa^Vaa      , Ms          , Ms          , Ms          , Ms          , Ha^Fpa      , Ha^Fma      , Aa          , Gs          , Gs          , Gs          , Ha          , Gs          , Gs          , Aa          , Aa          , Rd          , Rd          , Aa          , Aa          , Gs          , Aa          , Gs          , Aa          , Ha          , Ha^Fpa      , Ms          , Ms^Vhha     , Ms          , Ms          , Ms          , Ms          
Ms          , Ha^Fma      , Ha^Fma      , Ha^Fpa      , Aa          , Ms          , Ms          , Ms          , Ms          , Ha^Fma      , Aa^Fpa      , Aa          , Aa          , Aa          , Aa^Fpa      , Aa          , Aa          , Aa          , Aa          , Rd          , Aa          , Aa          , Aa          , Aa          , Aa          , Aa          , Gs          , Aa          , Aa          , Ha          , Ha^Fpa      , Ha^Fpa      , Ms          , Ms          , Ms          , Ms          
Ms          , Ms          , Ha^Fpa      , Aa          , Aa          , Ha^Fpa      , Ai          , Ha^Fma      , Ms          , Ha^Fma      , Aa^Fpa      , Aa^Fpa      , Aa^Fpa      , Aa^Fpa      , Ha^Fma      , Aa^Fpa      , Aa          , Aa          , Ai          , Rd          , Aa          , Ha          , Ha^Voa      , Ha^Fpa      , Aa          , Aa          , Aa          , Gs          , Aa          , Ha          , Ha^Fpa      , Ha^Fma      , Ms          , Ms          , Ms          , Ms          
Ms          , Ha^Fma      , Aa          , Aa          , Aa          , Aa          , Ai          , Ha^Fpa      , Ha^Fpa      , Aa^Fma      , Aa^Fpa      , Aa^Fpa      , Ha^Fma      , Ha^Fma      , Ms          , Ha^Fma      , Aa          , Ai          , Aa          , Aa          , Ha          , Ha          , Ms          , Ha^Fpa      , Ha^Fpa      , Aa          , Aa          , Aa          , Aa          , Aa          , Ha^Fpa      , Ha^Fpa      , Ms          , Ms          , Ms          , Ms          
Ha^Fma      , Ha^Fda      , Aa          , Cha         , Aa          , Ai          , Aa          , Aa          , Aa^Fma      , Aa^Fpa      , Aa^Fpa      , Ha^Fma      , Ms          , Ms          , Ms          , Ha^Fma      , Ai          , Ai          , Aa          , Ha          , Ms          , Ms          , Ms          , Ms          , Ha^Fpa      , Aa          , Aa          , Gs          , Gs          , Aa          , Aa          , Ha^Fpa      , Ha^Fpa      , Ms^Vhha     , Ms          , Ms          
Ha^Fma      , Aa          , Aa          , Aa          , Aa          , Ai          , Ai          , Aa          , Aa          , Aa^Fma      , Aa^Fpa      , Ha^Fma      , Ms          , Ms          , Ha^Fda      , Ha^Fma      , Ai          , Aa          , Ha          , Ha          , Ms          , Ms          , Ms^Xm       , Ms          , Ms          , Ha^Fpa      , Ha^Fpa      , Aa          , Aa          , Aa          , Aa          , Aa          , Aa          , Ha^Fpa      , Ha^Fpa      , Ms          
Ms          , Ha^Fma      , Aa          , Aa          , Aa          , Aa          , Ai          , Ai          , Aa          , Aa^Vaa      , Aa^Fma      , Ha^Fma      , Ha^Fpa      , Ha^Fpa      , Ai          , Ai          , Ha          , Ha          , Ha^Fma      , Ha^Fma      , Ms          , Ms^Xm       , Ms^Xm       , Ms          , Ms          , Ms          , Ha^Fpa      , Aa          , Aa          , Gs          , Aa          , Aa          , Aa          , Ha^Fpa      , Ha^Fpa      , Ha^Fpa      
Ms          , Ha^Fda      , Aa          , Aa          , Aa          , Ai          , Ww          , Ai          , Ai          , Aa          , Aa          , Aa^Fma      , Aa          , Ai          , Ms          , Ha          , Ha^Fma      , Ha^Fma      , Ha^Fma      , Ha^Fma      , Ms          , Ms^Xm       , Ms^Xm       , Ms          , Ms^Vhha     , Ms          , Ha^Fma      , Ha^Fpa      , Gs          , Gs          , Gs          , Aa          , Gs          , Aa          , Ha^Fpa      , Ha^Fpa      
Ha^Fma      , Ha^Fma      , Aa          , Cha         , Aa          , Ai          , Ww          , Ww          , Ai          , Ai          , Ai          , Aa          , Ai          , Ai          , Ms          , Ms          , Ms          , Ha^Fma      , Ms          , Ms          , Ms          , Ms^Xm       , Ms^Xm       , Ms          , Ms          , Ms          , Ms          , Ha^Fma      , Ha^Fma      , Aa          , Aa          , Aa          , Gs          , Aa          , Aa          , Ha^Fpa      
Ha^Fma      , Aa          , Aa          , 2 Kha       , Aa          , Ai          , Ai          , Ai          , Ai          , Aa          , Aa          , Ai          , Ha^Fma      , Ms          , Ha^Fma      , Ha^Fma      , Ms          , Ha^Fma      , Ms          , Ha^Fma      , Ms          , Ms^Xm       , Ms^Xm       , Ms          , Ms          , Ms          , Ms          , Ha^Fma      , Ha^Fpa      , Aa          , Ce          , Ce          , Ce          , Aa          , Gg          , Aa          
Aa          , Aa          , Aa^Vaa      , Aa          , Aa          , Aa          , Ai          , Ww          , Ai          , Aa          , Aa^Fma      , Aa^Fma      , Ms          , Ha^Fma      , Ms          , Ms          , Ms          , Ha^Vhha     , Ms          , Ms          , Ms          , Ms^Xm       , Ms^Xm       , Ms^Xm       , Ms^Xm       , Ms          , Ms          , Ms          , Ha^Fma      , Aa          , Ce          , 3 Ke        , Ce          , Gs          , Gs          , Aa          
Aa          , Aa          , Aa          , Aa          , Ai          , Ai          , Ai          , Ww          , Ai          , Aa          , Aa          , Ha^Fpa      , Ha^Fpa      , Ms          , Ms          , Ms          , Ms          , Ms          , Ha^Fpa      , Ms          , Ha^Fpa      , Ms          , Ms          , Ms^Xm       , Ms^Xm       , Ms^Xm       , Ms^Xm       , Ms          , Ha^Voa      , Ha^Fpa      , Ha^Fpa      , Ce          , Gg          , Gs          , Gs          , Gs          
Aa          , Aa          , Aa          , Aa          , Ai          , Ai          , Ww          , Ai          , Ai          , Aa          , Aa          , Ha^Fpa      , Ha^Fpa      , Ms          , Ha^Fpa      , Ha^Fpa      , Ms          , Ha^Fpa      , Ha^Fpa      , Ha^Fpa      , Ha^Fpa      , Ms          , Ms          , Ms          , Ms          , Ms^Xm       , Ms^Xm       , Ms^Xm       , Ms^Xm       , Ms          , Ms          , Ha^Fpa      , Ha^Fpa      , Aa          , Aa          , Aa          
Aa          , Aa          , Ai          , Ai          , Ai          , Ww          , Ai          , Ai          , Aa          , Aa          , Ha^Fma      , Ha^Fma      , Ms          , Ms          , Ms          , Ms          , Ms          , Ms          , Ms          , Ms          , Ms          , Ms          , Ms          , Ms          , Ms          , Ms          , Ms          , Ms^Xm       , Ms^Xm       , Ms          , Ms          , Ha^Fpa      , Ha^Fpa      , Ha^Fpa      , Aa          , Aa          
