border_size=1
usage=map

Ha^Fpa      , Aa          , Aa^Fpa      , Aa^Fpa      , Aa^Fpa      , Ha^Fma      , Ha^Fma      , Ms          , Ms          , Ms          , Ai          , Ai          , Ai          , Aa^Fpa      , Aa          , Aa^Fpa      , Aa^Fpa      , Ha^Fpa      , Aa^Fpa      , Ha^Fpa      , Ha^Fpa      , Ms          , Ha^Fpa      , Ms          , Ha          , Ms          , Ms          , Ha^Fpa      , Aa          , Aa          , Gs          , Aa          
Ha^Fpa      , Aa          , Aa          , Aa^Fpa      , Cea         , Aa^Fpa      , Aa^Fpa      , Ha^Fma      , Ha^Fpa      , Aa          , Ai          , Ha^Fpa      , Aa          , Ai          , Aa^Fpa      , Aa^Vdy      , Aa^Fpa      , Aa          , Gs^Fp       , Aa^Fpa      , Aa          , Ha^Fpa      , Aa^Fpa      , Ha^Fpa      , Aa^Voa      , Ha^Fma      , Ha^Fpa      , Ha^Fpa      , Aa          , Gs          , Aa          , Aa          
Aa          , Ha^Fpa      , Aa          , Cea         , 1 Ke        , Cea         , Gs          , Ha^Vdy      , Ai          , Ai          , Aa^Fpa      , Aa^Fpa      , Aa^Fma      , Ai          , Ai          , Aa          , Aa          , Gs^Fp       , Gs          , Gs          , Gs          , Gs          , Gs          , Aa^Fpa      , Aa          , Aa          , Coa         , Aa          , Gs          , Gs          , Aa          , Aa^Fpa      
Ha^Fpa      , Ha^Fpa      , Aa          , Ce          , Cea         , Cea         , Aa          , Aa          , Ai^Bw\      , Aa^Fma      , Gs^Fp       , Gs^Fp       , Gs          , Aa^Fma      , Aa          , Ai^Bw/      , Aa          , Aa          , Ha^Fpa      , Gs^Fp       , Ha^Fpa      , Aa          , Aa^Fma      , Aa          , Gs          , Coa         , 5 Ke        , Coa         , Aa          , Aa          , Ha^Fpa      , Ha^Fpa      
Ha^Fpa      , Ha^Fpa      , Ha^Fma      , Gs          , Aa^Fpa      , Aa^Fpa      , Ai          , Ai          , Aa^Fma      , Gs          , Aa          , Aa          , Ha^Fpa      , Aa^Fpa      , Ha^Fpa      , Ai          , Ha^Fpa      , Ha^Fpa      , Ms          , Ha^Fpa      , Ms          , Ha^Fma      , Aa          , Aa          , Gs          , Co          , Coa         , Coa         , Aa^Fpa      , Ha^Fpa      , Ms          , Ms          
Ms          , Ha^Fpa      , Aa^Vdy      , Gs          , Aa^Fpa      , Aa^Fpa      , Ai          , Aa          , Ha^Fpa      , Ha^Fpa      , Ha^Fpa      , Aa^Fma      , Ha^Fpa      , Ha^Fpa      , Ms          , Ai          , Ha^Fpa      , Ms          , Ms^Xm       , Ms          , Ms          , Ha^Fpa      , Aa^Fpa      , Gs          , Gs          , Aa          , Aa^Fma      , Aa^Fpa      , Ha^Fpa      , Ms          , Ms^Vhha     , Ms          
Ms          , Ms          , Ha^Fpa      , Aa^Fma      , Ha^Fpa      , Ai          , Ha^Fpa      , Ha^Fpa      , Ms          , Ms          , Ha^Fma      , Ha^Fpa      , Ha          , Ha^Fma      , Ha^Fpa      , Ai          , Ha^Fpa      , Ms          , Ms^Xm       , Ms^Xm       , Ms          , Ha^Fpa      , Ha^Fpa      , Aa          , Gs          , Aa          , Aa^Fma      , Aa^Fpa      , Ha^Fpa      , Ms          , Ms          , Ms          
Ha^Fpa      , Ms          , Ms          , Ha^Fpa      , Ha^Fpa      , Ai          , Ha^Fpa      , Ms          , Ha^Fma      , Ms          , Ha^Fma      , Ms          , Ha          , Ai          , Ai          , Ai          , Ha^Fpa      , Ms          , Ms^Xm       , Ms^Xm       , Ms^Vhha     , Ha^Fpa      , Ha^Fpa      , Ha^Fma      , Aa^Fma      , Gs          , Aa          , Aa^Fpa      , Aa^Fpa      , Ha^Fpa      , Ms          , Ms          
Ha          , Ha^Fpa      , Ha^Fpa      , Ha^Fpa      , Aa^Fma      , Ai          , Aa^Fma      , Ha^Fma      , Aa          , Ha          , Aa          , Ha^Fma      , Gs          , Aa          , Ha^Vdy      , Ai          , Ai          , Ms          , Ms          , Ms^Xm       , Ms          , Ai          , Ai          , Ai          , Ai          , Aa^Fma      , Ai^Bw|      , Aa          , Aa          , Ha^Fpa      , Ha^Fpa      , Ha^Fpa      
Aa          , Ha^Fpa      , Aa^Fma      , Aa^Fma      , Ai          , Ai          , Aa^Fma      , Aa          , Gs          , Aa          , Gs          , Aa          , Gs          , Ha^Fma      , Ha^Fpa      , Ha^Fpa      , Ms          , Ai          , Ms          , Ms^Xm       , Ms          , Ha^Fpa      , Ha^Fpa      , Ha^Fma      , Aa^Fma      , Ai          , Aa          , Ai          , Ai          , Ai          , Ai          , Ha^Fpa      
Aa          , Aa          , Aa          , Aa^Fma      , Ai          , Aa^Fma      , Gs          , Gs          , Gs          , Gs          , Ce          , Cea         , Cea         , Ha^Fpa      , Ms          , Ms          , Ms          , Ms          , Ms^Xm       , Ms^Xm       , Ms          , Ha^Fpa      , Ha^Fpa      , Aa          , Aa          , Aa^Fma      , Gs          , Aa^Fpa      , Ha^Fpa      , Ha^Fpa      , Ha^Fpa      , Ai          
Aa          , Aa^Vdy      , Aa          , Ai          , Aa^Fma      , Aa^Fma      , Gs          , Aa          , Aa^Fma      , Gs          , Cea         , 2 Ke        , Cea         , Ha^Fma      , Ms          , Ms          , Ms^Xm       , Ms^Xm       , Ms          , Ms          , Ha^Fpa      , Ha^Fpa      , Aa          , Aa          , Aa^Fpa      , Aa^Fma      , Gs          , Aa          , Ha^Fpa      , Ha^Fpa      , Ms          , Ha^Fpa      
Aa          , Aa          , Gs          , Ai          , Ai^Bw/      , Aa          , Aa          , Aa          , Ha^Fma      , Aa^Fma      , Ha^Fma      , Cea         , Ha^Fma      , Ms          , Ms          , Ms^Xm       , Ms          , Ms          , Ms          , Aa^Fpa      , Aa          , Aa          , Aa^Fpa      , Gs^Fp       , Gs          , Aa          , Gs          , Aa          , Aa^Fpa      , Ha^Fda      , Ms          , Ms          
Aa          , Aa          , Gs          , Gs          , Ha^Fpa      , Ai          , Ha^Fpa      , Ha^Fpa      , Ms          , Ha^Fma      , Ms          , Ms          , Ms          , Ms          , Ms          , Ms          , Ha^Fma      , Ha^Vdy      , Ha^Fpa      , Ha          , Aa^Fpa      , Aa^Fma      , Aa^Fpa      , Gs          , Aa          , Gs          , Gs^Fp       , Gs          , Gs^Fp       , Ha^Fda      , Ms          , Ms          
Gs          , Gs          , Aa          , Aa^Fma      , Ha^Fpa      , Ha^Fpa      , Ms          , Ms^Vdy      , Ha^Fda      , Ms          , Ms          , Ms          , Ha^Fma      , Ms          , Ha^Fpa      , Ha^Fpa      , Aa^Fpa      , Ha^Fpa      , Aa^Fpa      , Aa          , Aa          , Gs          , Aa          , Aa          , Gs          , Aa^Fma      , Aa^Fpa      , Gs^Fp       , Ha^Fpa      , Ha^Voa      , Ms          , Ms          
Aa          , Gs          , Aa          , Ha^Fpa      , Ms          , Ms          , Ms^Xm       , Ms          , Ms          , Ms          , Ha^Fpa      , Ha^Fpa      , Aa^Fma      , Ha^Fpa      , Aa^Fma      , Aa^Fpa      , Gs^Fp       , Aa^Fpa      , Aa^Fpa      , Aa^Fma      , Gs          , Gs          , Aa          , Gs          , Aa          , Gs^Fp       , Aa^Fpa      , Ha^Fpa      , Aa^Fpa      , Ha^Fpa      , Ha^Fpa      , Ms          
Ha^Fpa      , Aa          , Aa          , Ha^Fpa      , Ms          , Ms^Xm       , Ms^Xm       , Ms^Xm       , Ms          , Ms          , Ha^Fma      , Ai          , Ai          , Aa^Fma      , Aa          , Gs          , Gs          , Gs          , Gs^Fp       , Gs          , Aa          , Aa          , Ha          , Ha^Fpa      , Ha^Fpa      , Ha^Fma      , Ha^Fma      , Aa          , Aa          , Aa          , Ha^Fpa      , Ms          
Ms          , Ha^Fpa      , Ha^Fpa      , Ha^Fpa      , Ms          , Ms^Xm       , Ms          , Ms          , Ha^Fpa      , Ha^Fpa      , Aa^Fpa      , Aa^Fpa      , Aa          , Ai          , Aa          , Aa          , Gs          , Gs^Fp       , Ha^Fpa      , Aa^Fpa      , Ha^Fma      , Ha          , Ms          , Ms          , Ms          , Ms          , Ha^Fma      , Aa^Fpa      , Ha^Fma      , Ha^Fpa      , Ms          , Ms          
Ms          , Ha^Fma      , Ms          , Ms          , Ms          , Ms          , Ms          , Ha^Fma      , Aa^Fpa      , Aa^Fpa      , Aa^Vha      , Gs          , Aa^Fpa      , Ai          , Ai          , Aa          , Aa^Fpa      , Aa^Fpa      , Ha^Fma      , Ms          , Ms          , Ms          , Ha^Fma      , Ms          , Ha^Fda      , Ha^Fda      , Aa          , Aa^Fpa      , Ha^Fma      , Ms          , Ms          , Ms          
Ha^Fpa      , Ha^Fma      , Ha^Vdy      , Ha^Fma      , Ha^Fpa      , Ha^Fpa      , Ha^Fpa      , Ha^Fma      , Aa^Fma      , Aa^Fpa      , Aa          , Gs          , Gs^Fp       , Ha^Fpa      , Aa^Fpa      , Ai          , Ai          , Ha^Fpa      , Ms          , Ms          , Ms          , Ha^Voa      , Ha^Fpa      , Ha^Fda      , Gs          , Gs          , Gs          , Aa^Fpa      , Aa^Fma      , Ha^Fma      , Ms          , Ms          
Aa^Fma      , Ha^Fma      , Aa^Fma      , Aa^Fda      , Aa^Fma      , Aa^Fda      , Ha^Fpa      , Aa^Fma      , Gs          , Aa          , Gs          , Gs          , Gs^Fp       , Gs          , Gs          , Aa^Fpa      , Ai          , Ha^Fpa      , Ha^Fpa      , Ha          , Ha^Fpa      , Ms          , Ha^Fpa      , Aa          , Gs          , Gs          , Gs          , Gs          , Aa^Fma      , Ha^Fpa      , Ms          , Ms          
Gs          , Aa^Fma      , Gs          , Aa^Fma      , Aa          , Aa^Fma      , Aa^Fma      , Aa^Fma      , Gs          , Gs          , Aa^Fda      , Aa^Fma      , Ha^Fpa      , Gs^Fp       , Aa^Fpa      , Aa          , Aa          , Ai          , Ai          , Aa^Fma      , Aa^Fma      , Ha^Fpa      , Aa          , Aa          , Gs          , Gs          , Aa          , Coa         , Ha^Fma      , Ha^Fma      , Ms          , Ms          
Aa          , Gs          , Gs          , Gs          , Gs          , Gs          , Co          , Coa         , Co          , Gs          , Aa^Fma      , Aa^Fma      , Ha^Fpa      , Ha^Fpa      , Ha^Fpa      , Gs^Fp       , Gs^Fp       , Aa          , Ww          , Aa          , Aa^Fma      , Aa          , Gs          , Gs          , Gs          , Aa          , Aa^Fma      , Ha^Fma      , Ha^Fpa      , Ms          , Ms          , Ms          
Aa^Fda      , Aa          , Aa          , Aa          , Aa          , Gs          , Coa         , 4 Ke        , Coa         , Aa^Fma      , Ha^Fpa      , Ha^Fpa      , Ms          , Ms          , Ms          , Ha^Fpa      , Gs^Fp       , Ww          , Gs          , Gs          , Gs          , Gs          , Gs          , Aa          , Coa         , Coa         , Coa         , Aa^Fma      , Aa          , Ha^Fpa      , Ha^Fma      , Ms          
Aa^Fda      , Aa^Fda      , Aa          , Aa^Fma      , Ha^Fma      , Aa^Fma      , Aa^Fma      , Coa         , Aa^Fma      , Ha^Fma      , Ha^Fpa      , Ms          , Ms          , Ms          , Ha^Fpa      , Ha^Fpa      , Aa          , Ww          , Gs          , Gs          , Gs          , Coa         , Gs          , Aa          , Co          , 3 Ke        , Co          , Gs          , Aa^Voa      , Aa          , Ha^Fpa      , Ms          
Ha^Fpa      , Ha^Fpa      , Ha^Fpa      , Ha^Fpa      , Ms          , Ha^Fpa      , Ha^Fpa      , Ha^Fpa      , Ha^Fpa      , Ha^Fpa      , Ha^Fpa      , Ha^Fpa      , Ms          , Ms          , Ms          , Ha^Fma      , Aa^Voa      , Ai          , Ww          , Gs          , Aa          , Aa          , Gs          , Gs          , Gs          , Coa         , Gs          , Gs          , Gs          , Aa          , Ha^Fpa      , Ha^Fpa      
Ms          , Ms          , Ha^Fma      , Ha^Vhha     , Ms          , Ms          , Ms          , Ms          , Ms          , Ms          , Ms          , Ms          , Ha^Fma      , Ms          , Ms          , Ha^Fpa      , Ha^Fpa      , Aa          , Ai          , Aa          , Aa^Fma      , Aa^Fma      , Aa          , Gs          , Aa          , Aa          , Gs          , Gs          , Aa          , Aa          , Aa^Fma      , Ha^Fpa      
Ms          , Ms          , Ms          , Ms          , Ms          , Ms          , Ms          , Ms          , Ms          , Ms          , Ms          , Ms          , Ms          , Ms          , Ms          , Ms          , Ms          , Ha^Fpa      , Ha^Fpa      , Ai          , Ha^Fpa      , Ha^Fpa      , Ha^Fpa      , Aa^Fma      , Ha^Fpa      , Aa          , Aa          , Gs          , Gs          , Aa          , Ha^Fpa      , Ha^Fpa      
