border_size=1
usage=map

Ms          , Ms          , Ha^Fma      , Ha^Fma      , Aa^Fma      , Aa^Fma      , Ha^Fpa      , Ms          , Ms          , Ha^Fpa      , Ha^Fpa      , Aa^Fma      , Aa^Fma      , Ha^Fpa      , Ha^Fpa      , Aa^Fma      , Gg          , Gg          , Gg          , Gg          , Gg          , Gg          , Gs          , Gs          , Ww          , Gs          , Gs          , Gs          , Ss          , Ss          , Gg          , Gg          , Re          , Re          
Ha^Fpa      , Ha^Fpa      , Aa^Fma      , Aa^Fma      , Gs          , Gs          , Aa^Fma      , Ha^Fpa      , Ha^Fma      , Ha^Fpa      , Ha^Fpa      , Aa^Fma      , Gg          , Aa^Fda      , Aa^Fma      , Aa^Fma      , Gg          , Gg          , Gs^Fmf      , Gg          , Gg          , Ss          , Ss          , Gs          , Ww          , Gs          , Ss          , Ss          , Ss          , Ss          , Gg          , Gg          , Re          , Gg          
Ha^Fpa      , Aa^Fma      , Ce          , Ce          , Ce          , Gs          , Gs          , Aa^Fma      , Aa^Fma      , Aa^Fma      , Aa^Fma      , Aa^Fma      , Gg          , Gg          , Gg          , Gg          , Gg          , Gs^Fmf      , Gs^Fmf      , Gs^Fmf      , Gg          , Gg          , Ww          , Ww          , Ss          , Gs          , Gs          , Ss          , Ss          , Gg          , Gg          , Re          , Gg          , Gg          
Gs          , Gs          , Ce          , 1 Ke        , Ce          , Gg          , Gg          , Gs          , Aa^Fma      , Aa^Fma      , Gg          , Gg          , Gs^Fmf      , Gs^Fmf      , Gg          , Gg^Vo       , Gg          , Gg          , Gg          , Gg          , Ww          , Gg          , Ww          , Ss          , Ss          , Gs          , Ss          , Ss          , Ss          , Gg          , Re          , Re          , Gg          , Ss          
Aa^Fma      , Gs          , Gs          , Ce          , Gg          , Gg          , Gg          , Aa^Fma      , Aa^Fma      , Gg          , Gg          , Gg          , Gs^Fmf      , Gs^Fmf      , Gg          , Gg          , Ww          , Ww          , Ww          , Ww          , Gs          , Ww          , Gs          , Gs          , Gs          , Gs          , Ss          , Ss          , Gg          , Gg          , Re          , Gg          , Ss          , Ss          
Ha^Fma      , Aa^Fma      , Aa^Fma      , Gg          , Gg          , Gg          , Gg          , Gg          , Aa^Fma      , Aa^Fma      , Gg          , Gg          , Gg          , Gg          , Ww          , Ww          , Gs          , Gs          , Gs          , Gs          , Ds          , Gs          , Ds          , Gs          , Gs          , Ss          , Ss^Vhs      , Ss          , Gg          , Re          , Gg          , Gg          , Ss          , Ss          
Ha^Fma      , Ha^Fma      , Aa^Fma      , Gg          , Aa^Fma      , Aa^Fma      , Gg          , Gg          , Gg          , Gg          , Gg          , Gg^Vo       , Gs          , Gs          , Ww          , Gs          , Gs          , Ds          , Ds          , Ds          , Dd^Vda      , Ds          , Gs          , Gs          , Ss          , Ss          , Ss          , Gg          , Re          , Re          , Gg          , Ss          , Ss          , Ss          
Aa^Fma      , Aa^Fma      , Gg          , Gg          , Gg          , Aa^Fma      , Gg          , Gs          , Gs          , Gs          , Gs          , Gs          , Gs          , Ww          , Gs          , Gs          , Gs          , Ds          , Co          , Ds          , Ds          , Ds          , Gs          , Ss          , Ss          , Ss          , Gg          , Gg          , Re          , Gg          , Gg          , Gg          , Ss          , Ss          
Gg          , Gg          , Gg          , Gg^Vo       , Gg          , Gg          , Ww          , Gs          , Ww          , Gs          , Ww^Bw\      , Ww          , Ww          , Ww          , Gs          , Gs^Fmw      , Gs          , Ko          , Ds          , Ds          , Gs          , Ds          , Gs          , Gs          , Ss          , Gg          , Gg          , Re          , Gg          , Gg          , Ss^Vhs      , Gg          , Ss          , Ss          
Gg          , Gs^Fmf      , Gs^Fmf      , Gg          , Gg          , Ww          , Gg          , Ww          , Gg          , Ww          , Gg          , Gg          , Gg          , Gg          , Gg          , Gs^Fmw      , Gg          , Gg          , Gg          , Gs          , Gs          , Gs          , Gs          , Gg          , Gg          , Gg          , Re          , Re          , Gg          , Ss          , Ss          , Gg          , Ss          , Ss          
Gg          , Gs^Fmf      , Gs^Fmf      , Gg          , Ww          , Ww          , Gg          , Gg          , Gg          , Gg          , Gs^Fmw      , Gs^Fdw      , Hh^Fdw      , Gg          , Gg          , Gg          , Gg          , Ch          , Gg          , Ch          , Ss          , Ch          , Gg          , Ch          , Gg          , Ch          , Re          , Gg          , Gg          , Gg          , Ss          , Ss          , Ss          , Ss          
Gg          , Gg          , Gg          , Gg          , Ww          , Gg          , Gg          , Gg^Vo       , Gg          , Gs^Fmw      , Gs^Fmw      , Gs^Fmw      , Gg          , Gg          , Gg          , Ch          , Gg          , Gg          , Ss          , Gg          , Ss          , Ss          , Gg          , Gg          , Re          , Re          , Gg          , Ch          , Gg          , Ss          , Gg          , Ss          , Gg          , Ss          
Gg          , Gg          , Gg          , Ww          , Gg          , Gg          , Gg          , Gg          , Gg          , Gg          , Gg          , Gg          , Gg          , Ch          , Gg          , Gg          , Ch          , Ch          , Ch          , Ss          , Gg          , Gg          , Re          , Re          , Ch          , Ch          , Ch          , Hh          , Hh          , Ch          , Hh          , Gg          , Gg          , Ss          
Ww          , Ww          , Ww          , Ww          , Gg          , Hh          , Hh          , Hh          , Hh          , Gg          , Hh          , Ch          , Hh          , Hh          , Hh          , Hh          , Ch          , 4 Kh        , Ch          , Gg          , Gg          , Re          , Gg          , Gg          , Ch          , 3 Kh        , Ch          , Mm          , Hh          , Mm          , Hh          , Ch          , Ss          , Ss          
Gg          , Gg          , Gg          , Gg          , Hh          , Hh          , Hh          , Hh          , Hh          , Hh          , Hh          , Hh          , Mm          , Mm^Vc       , Mm          , Mm          , Hh^Vo       , Chr         , Mm          , Hh          , Ch          , Re          , Ch          , Gg          , Hh^Vo       , Ch          , Hh          , Mm          , Hh          , Mm          , Hh^Vo       , Hh          , Ss          , Ss          
Gg          , Gg          , Gs^Fp       , Gs^Fp       , Hh          , Hh^Vo       , Hh          , Hh          , Re^Gvs      , Hh          , Hh          , Ch          , Hh          , Hh          , Gg          , Hh          , Hh          , Mm          , Hh          , Hh          , Hh          , Re          , Hh          , Hh          , Hh          , Hh          , Re          , Hh^Vo       , Hh          , Hh          , Hh          , Ch          , Ss          , Ss          
Gg          , Gg          , Gs^Fp       , Gs^Fp       , Hh          , Hh          , Hh          , Re^Gvs      , Re^Gvs      , Gg          , Hh          , Hh          , Hh^Vo       , Gg          , Gg          , Gg          , Hh          , Hh          , Gg          , Hh          , Ch          , Ch          , Ch          , Hh          , Gg          , Re          , Gg          , Re          , Gg          , Re          , Gg          , Hh          , Re          , Ss          
Gg          , Gg          , Gs^Fp       , Gs^Fp       , Re^Gvs      , Re^Gvs      , Re^Gvs      , Re^Gvs      , Re^Gvs      , Hh          , Hh          , Ch          , Hh          , Hh          , Gg          , Hh          , Hh^Vo       , Gg          , Gg          , Gg          , Ch          , 2 Kh        , Ch          , Gg          , Gg          , Gg          , Gg          , Gg          , Hh^Vo       , Gg          , Gg          , Ch          , Re          , Re          
Gg          , Gg          , Re^Gvs      , Re^Gvs      , Re^Gvs      , Re^Gvs      , Re^Gvs      , Re^Gvs      , Re^Gvs      , Re^Gvs      , Gg          , Hh          , Re          , Gg          , Gg^Vo       , Re          , Re          , Re          , Gg          , Gg          , Re          , Ch          , Re          , Gg          , Gg          , Gg          , Gg^Vo       , Gg          , Hh          , Hh^Vo       , Re          , Re          , Ss          , Ss          
Re^Gvs      , Re^Gvs      , Re^Gvs      , Re^Gvs      , Re          , Gg^Vo       , Re^Gvs      , Re^Gvs      , Re          , Re          , Re          , Ch          , Re          , Re          , Re          , Re          , Re          , Re          , Re          , Ch          , Ch          , Re          , Ch          , Ch          , Re          , Gg          , Re          , Gg          , Re          , Re          , Ds          , Ch          , Ss          , Ss          
Re^Gvs      , Re^Gvs      , Re          , Re          , Re^Gvs      , Re          , Re          , Re          , Re^Gvs      , Re^Gvs      , Gg          , Gg          , Gg^Vo       , Re          , Ds          , Ds          , Ds          , Re          , Ch          , Ch          , Ds          , Ds          , Ds          , Ch          , Ch          , Re          , Re          , Re          , Ch          , Ds          , Ds          , Ds          , Ss          , Ss          
Gg          , Gg          , Re^Gvs      , Re^Gvs      , Re^Gvs      , Re^Gvs      , Re^Gvs      , Re^Gvs      , Re^Gvs      , Re^Gvs      , Ds          , Ch          , Ch          , Re          , Ch          , Ds          , Ds          , Ch          , Ch          , Ds          , Ww          , Ww^Bw|      , Ww          , Ds          , Ch          , Ch          , Ch          , Ch          , Ds          , Ds          , Ds          , Ds          , Ds          , Ss          
Re^Gvs      , Re^Gvs      , Re^Gvs      , Re^Gvs      , Gg          , Re^Gvs      , Gg          , Gg^Vo       , Ds          , Ds          , Ds          , Ds          , Ds          , Ch          , Ds          , Ds          , Ww          , Ds          , Ds          , Ds          , Ww          , Ww          , Ww          , Ds          , Ds          , Ds          , Ds          , Ds          , Ds          , Ds          , Wo^Bw|      , Ds          , Ds          , Ds          
Re^Gvs      , Re^Gvs      , Ds          , Ds          , Ds          , Ds          , Ds          , Ds          , Ds          , Ds          , Ww          , Ds          , Ww          , Ds          , Ww          , Ww          , Wo          , Ww          , Ww          , Ww          , Ww          , Ww          , Ww          , Ww          , Ww          , Ww          , Ww          , Ww          , Ds          , Wo          , Wo          , Wo          , Ds          , Ds          
Ds          , Ds          , Ds          , Ds          , Ww          , Ds          , Ww          , Ds          , Ww          , Ww          , Wo          , Ww          , Wo          , Ww          , Wo          , Wo          , Wo          , Wo          , Wo          , Wo          , Ww          , Ww          , Wo          , Wo          , Wo          , Wo          , Wo          , Ww          , Ww          , Wo          , Ww          , Wo          , Ds          , Ds          
Ds          , Ds          , Ds          , Ww          , Wo          , Ww          , Wo          , Ww          , Wo          , Wo          , Wo          , Wo          , Ww          , Wo          , Ww          , Wo          , Ww          , Wo          , Ww          , Wo          , Ww          , Ww          , Ww          , Wo          , Wo          , Ww          , Ww          , Wo          , Wo          , Ww          , Ww          , Ww          , Ww          , Wo          
Ds          , Ds          , Wo          , Wo          , Wo          , Wo          , Wo          , Wo          , Wo          , Wo          , Wo          , Wo          , Ww          , Ww          , Wo          , Wo          , Ww          , Ww          , Wo          , Wo          , Wo          , Ww          , Wo          , Ww          , Wo          , Ww          , Wo          , Wo          , Wo          , Ww          , Wo          , Wo          , Wo          , Wo          
